Time_Stamp,node_1,light_1,sound_1,temperature_1,smoke_1,sum 
22:50:41,1,0,0,0,0,0
22:50:42,1,1003,493,538,0,2034
22:50:43,1,1003,503,538,0,2044
22:50:44,1,0,0,0,0,0
22:50:45,1,0,0,0,0,0
22:50:46,1,0,0,0,0,0
22:50:47,1,0,0,0,0,0
22:50:48,1,0,0,0,0,0
22:50:49,1,1003,506,539,0,2048
22:50:50,1,1003,469,539,0,2011
22:50:51,1,0,0,0,0,0
22:50:52,1,0,0,0,0,0
22:50:53,1,0,0,0,0,0
22:50:54,1,1003,494,539,0,2036
22:50:55,1,0,0,0,0,0
22:50:56,1,0,0,0,0,0
22:50:57,1,0,0,0,0,0
22:50:58,1,0,0,0,0,0
22:50:59,1,1003,499,538,0,2040
22:51:00,1,1003,494,538,0,2035
22:51:01,1,0,0,0,0,0
22:51:02,1,1003,495,538,0,2036
22:51:03,1,1003,470,538,0,2011
22:51:04,1,0,0,0,0,0
22:51:05,1,1003,491,538,0,2032
22:51:06,1,1003,485,538,0,2026
22:51:07,1,1003,494,538,0,2035
22:51:08,1,1003,489,538,0,2030
22:51:09,1,1003,487,539,0,2029
22:51:10,1,0,0,0,0,0
22:51:11,1,1002,478,538,0,2018
22:51:12,1,1003,492,539,0,2034
22:51:13,1,1002,497,538,0,2037
22:51:14,1,1003,482,538,0,2023
22:51:15,1,0,0,0,0,0
22:51:16,1,1003,492,538,0,2033
22:51:17,1,1003,476,538,0,2017
22:51:18,1,1003,499,538,0,2040
22:51:19,1,1003,487,538,0,2028
22:51:20,1,1003,496,538,0,2037
22:51:21,1,1003,527,538,0,2068
22:51:22,1,0,0,0,0,0
22:51:23,1,0,0,0,0,0
22:51:24,1,0,0,0,0,0
22:51:25,1,0,0,0,0,0
22:51:26,1,1003,642,539,0,2184
22:51:27,1,0,0,0,0,0
22:51:28,1,1003,498,538,0,2039
22:51:29,1,1003,494,538,0,2035
22:51:30,1,1003,500,538,0,2041
22:51:31,1,1003,500,538,0,2041
22:51:32,1,1002,496,538,0,2036
22:51:33,1,1003,471,538,0,2012
22:51:34,1,1003,490,538,0,2031
22:51:35,1,1003,496,538,0,2037
22:51:36,1,1003,498,538,0,2039
22:51:37,1,1003,501,538,0,2042
22:51:38,1,0,0,0,0,0
22:51:39,1,0,0,0,0,0
22:51:40,1,0,0,0,0,0
22:51:41,1,0,0,0,0,0
22:51:42,1,0,0,0,0,0
22:51:43,1,1003,496,538,502,2539
22:51:44,1,0,0,0,0,0
22:51:45,1,1003,492,538,352,2385
22:51:46,1,0,0,0,0,0
22:51:47,1,0,0,0,0,0
22:51:48,1,0,0,0,0,0
22:51:49,1,0,0,0,0,0
22:51:50,1,0,0,0,0,0
22:51:51,1,1003,501,538,505,2547
22:51:52,1,1003,488,538,521,2550
22:51:53,1,1003,496,538,519,2556
22:51:54,1,1003,485,538,499,2525
22:51:55,1,1003,496,538,461,2498
22:51:56,1,0,0,0,0,0
22:51:57,1,0,0,0,0,0
22:51:58,1,1004,507,540,572,2623
22:51:59,1,1005,493,547,404,2449
22:52:00,1,1006,516,551,308,2381
22:52:01,1,0,0,0,0,0
22:52:02,1,1005,493,557,573,2628
22:52:03,1,1004,490,559,437,2490
22:52:04,1,1005,508,560,704,2777
22:52:05,1,1004,476,564,450,2494
22:52:06,1,0,0,0,0,0
22:52:07,1,1003,493,566,576,2638
22:52:08,1,1004,487,568,449,2508
22:52:09,1,1003,643,571,559,2776
22:52:10,1,1003,487,573,549,2612
22:52:11,1,1004,466,580,428,2478
22:52:12,1,1004,520,583,452,2559
22:52:13,1,1003,505,586,474,2568
22:52:14,1,1003,496,588,462,2549
22:52:15,1,1004,507,591,440,2542
22:52:16,1,1003,476,593,496,2568
22:52:17,1,1004,499,595,506,2604
22:52:18,1,1004,489,597,485,2575
22:52:19,1,1003,491,602,510,2606
22:52:20,1,1002,491,609,455,2557
22:52:21,1,1002,492,610,521,2625
22:52:22,1,1004,514,613,429,2560
22:52:23,1,1003,474,615,548,2640
22:52:24,1,1003,511,618,542,2674
22:52:25,1,1003,483,622,517,2625
22:52:26,1,1004,479,624,482,2589
22:52:27,1,1004,526,626,376,2532
22:52:28,1,1002,478,628,480,2588
22:52:29,1,1002,526,636,509,2673
22:52:30,1,1002,522,636,472,2632
22:52:31,1,1002,499,636,515,2652
22:52:32,1,1001,495,638,540,2674
22:52:33,1,1002,496,639,877,3014
22:52:34,1,1002,492,641,875,3010
22:52:35,1,1002,478,643,885,3008
22:52:36,1,1002,489,644,866,3001
22:52:37,1,1002,499,645,892,3038
22:52:38,1,1002,500,646,907,3055
22:52:39,1,1002,487,647,891,3027
22:52:40,1,1002,496,648,908,3054
22:52:41,1,1002,494,650,897,3043
22:52:42,1,0,0,0,0,0
22:52:43,1,0,0,0,0,0
22:52:44,1,1002,511,653,837,3003
22:52:45,1,1002,494,655,913,3064
22:52:46,1,1002,482,655,845,2984
22:52:47,1,1002,497,655,897,3051
22:52:48,1,1002,489,655,842,2988
22:52:49,1,0,0,0,0,0
22:52:50,1,0,0,0,0,0
22:52:51,1,0,0,0,0,0
22:52:52,1,0,0,0,0,0
22:52:53,1,0,0,0,0,0
22:52:54,1,0,0,0,0,0
22:52:55,1,0,0,0,0,0
22:52:56,1,1002,485,659,872,3018
22:52:57,1,0,0,0,0,0
22:52:58,1,0,0,0,0,0
22:52:59,1,0,0,0,0,0
22:53:00,1,0,0,0,0,0
22:53:01,1,0,0,0,0,0
22:53:02,1,0,0,0,0,0
22:53:03,1,0,0,0,0,0
22:53:04,1,0,0,0,0,0
22:53:05,1,1002,497,662,768,2929
22:53:06,1,0,0,0,0,0
22:53:07,1,1002,512,661,873,3048
22:53:08,1,1002,514,662,900,3078
22:53:09,1,0,0,0,0,0
22:53:10,1,1003,481,662,761,2907
22:53:11,1,0,0,0,0,0
22:53:12,1,0,0,0,0,0
22:53:13,1,0,0,0,0,0
22:53:14,1,0,0,0,0,0
22:53:15,1,1002,494,667,868,3031
22:53:16,1,1003,510,668,826,3007
22:53:17,1,1003,482,669,888,3042
22:53:18,1,1002,506,671,889,3068
22:53:19,1,1002,524,670,892,3088
22:53:20,1,1002,491,670,911,3074
22:53:21,1,1002,487,670,837,2996
22:53:22,1,1003,510,672,991,3176
22:53:23,1,0,0,0,0,0
22:53:24,1,1002,499,674,854,3029
22:53:25,1,1002,493,675,915,3085
22:53:26,1,1002,492,675,769,2938
22:53:27,1,1002,499,676,765,2942
22:53:28,1,1002,504,677,810,2993
22:53:29,1,1003,481,686,872,3042
22:53:30,1,1004,490,687,942,3123
22:53:31,1,1003,491,689,986,3169
22:53:32,1,1004,497,693,894,3088
22:53:33,1,1003,492,696,957,3148
22:53:34,1,1003,499,697,895,3094
22:53:35,1,1003,494,698,893,3088
22:53:36,1,1002,342,697,887,2928
22:53:37,1,1002,342,697,794,2835
22:53:38,1,1002,483,698,878,3061
22:53:39,1,1002,494,698,923,3117
22:53:40,1,1001,502,698,851,3052
22:53:41,1,1002,505,699,871,3077
22:53:42,1,0,0,0,0,0
22:53:43,1,1002,489,700,874,3065
22:53:44,1,1002,490,700,899,3091
22:53:45,1,1002,494,700,870,3066
22:53:46,1,1002,489,698,903,3092
22:53:47,1,1002,506,698,827,3033
22:53:48,1,1002,499,698,766,2965
22:53:49,1,1002,486,698,905,3091
22:53:50,1,1002,488,698,824,3012
22:53:51,1,1002,495,698,862,3057
22:53:52,1,1002,498,698,882,3080
22:53:53,1,1002,501,699,798,3000
22:53:54,1,1002,500,701,983,3186
22:53:55,1,1002,487,701,987,3177
22:53:56,1,0,0,0,0,0
22:53:57,1,0,0,0,0,0
22:53:58,1,1001,490,700,827,3018
22:53:59,1,1001,488,700,908,3097
22:54:00,1,1002,501,701,953,3157
22:54:01,1,1002,494,700,864,3060
22:54:02,1,1002,488,700,985,3175
22:54:03,1,1001,498,700,899,3098
22:54:04,1,0,0,0,0,0
22:54:05,1,1002,501,700,864,3067
22:54:06,1,0,0,0,0,0
22:54:07,1,0,0,0,0,0
22:54:08,1,1002,504,700,965,3171
22:54:09,1,1001,498,700,897,3096
22:54:10,1,1001,488,700,855,3044
22:54:11,1,1002,465,700,763,2930
22:54:12,1,1001,489,700,860,3050
22:54:13,1,1001,509,700,879,3089
22:54:14,1,1001,510,700,977,3188
22:54:15,1,1002,483,700,889,3074
22:54:16,1,1004,510,704,755,2973
22:54:17,1,0,0,0,0,0
22:54:18,1,1003,502,707,861,3073
22:54:19,1,0,0,0,0,0
22:54:20,1,1002,493,708,921,3124
22:54:21,1,1003,497,709,974,3183
22:54:22,1,1002,489,709,854,3054
22:54:23,1,1001,486,709,867,3063
22:54:24,1,1002,494,710,893,3099
22:54:25,1,1001,498,711,884,3094
22:54:26,1,1001,490,711,840,3042
22:54:27,1,1001,485,711,870,3067
22:54:28,1,1001,499,711,910,3121
22:54:29,1,1001,486,712,778,2977
22:54:30,1,1001,497,712,934,3144
22:54:31,1,1001,497,712,869,3079
22:54:32,1,1001,496,712,938,3147
22:54:33,1,1001,500,712,893,3106
22:54:34,1,1001,494,712,891,3098
22:54:35,1,1001,496,712,893,3102
22:54:36,1,1001,498,712,886,3097
22:54:37,1,1001,500,712,901,3114
22:54:38,1,1001,496,712,906,3115
22:54:39,1,1001,480,711,920,3112
22:54:40,1,1001,493,711,887,3092
22:54:41,1,1001,492,710,762,2965
22:54:42,1,1001,498,710,889,3098
22:54:43,1,1001,485,710,873,3069
22:54:44,1,1001,493,710,811,3015
22:54:45,1,1001,488,709,915,3113
22:54:46,1,1001,496,708,869,3074
22:54:47,1,1001,498,706,921,3126
22:54:48,1,1001,497,705,824,3027
22:54:49,1,1001,501,704,830,3036
22:54:50,1,1001,489,703,866,3059
22:54:51,1,1001,496,702,898,3097
22:54:52,1,1001,499,701,823,3024
22:54:53,1,1002,489,700,905,3096
22:54:54,1,1001,496,700,888,3085
22:54:55,1,1002,493,700,835,3030
22:54:56,1,1001,495,699,927,3122
22:54:57,1,0,0,0,0,0
22:54:58,1,1002,494,696,871,3063
22:54:59,1,1002,496,695,904,3097
22:55:00,1,1002,498,695,887,3082
22:55:01,1,1002,496,694,876,3068
22:55:02,1,1002,498,694,907,3101
22:55:03,1,1002,502,694,879,3077
22:55:04,1,0,0,0,0,0
22:55:05,1,1002,488,693,822,3005
22:55:06,1,1002,490,693,893,3078
22:55:07,1,0,0,0,0,0
22:55:08,1,0,0,0,0,0
22:55:09,1,1002,492,694,868,3056
22:55:10,1,1002,490,694,892,3078
22:55:11,1,1001,494,694,856,3045
22:55:12,1,1002,505,694,931,3132
22:55:13,1,1001,497,693,849,3040
22:55:14,1,1002,480,692,916,3090
22:55:15,1,1002,479,693,873,3047
22:55:16,1,1002,505,695,891,3093
22:55:17,1,1002,803,696,949,3450
22:55:18,1,0,0,0,0,0
22:55:19,1,1002,514,699,910,3125
22:55:20,1,0,0,0,0,0
22:55:21,1,1002,464,699,906,3071
22:55:22,1,1002,546,699,860,3107
22:55:23,1,1002,502,699,872,3075
22:55:24,1,1002,481,699,810,2992
22:55:25,1,0,0,0,0,0
22:55:26,1,1002,506,700,870,3078
22:55:27,1,1002,507,700,917,3126
22:55:28,1,1002,494,699,856,3051
22:55:29,1,1001,492,699,849,3041
22:55:30,1,1002,479,699,834,3014
22:55:31,1,1001,505,699,846,3051
22:55:32,1,1002,492,699,869,3062
22:55:33,1,1001,494,698,966,3159
22:55:34,1,1001,500,698,880,3079
22:55:35,1,1001,497,698,801,2997
22:55:36,1,1001,493,698,838,3030
22:55:37,1,0,0,0,0,0
22:55:38,1,1002,502,698,797,2999
22:55:39,1,0,0,0,0,0
22:55:40,1,0,0,0,0,0
22:55:41,1,0,0,0,0,0
22:55:42,1,1002,499,697,911,3109
22:55:43,1,1002,515,697,902,3116
22:55:44,1,0,0,0,0,0
22:55:45,1,0,0,0,0,0
22:55:46,1,1002,492,696,836,3026
22:55:47,1,0,0,0,0,0
22:55:48,1,1001,494,695,928,3118
22:55:49,1,0,0,0,0,0
22:55:50,1,0,0,0,0,0
22:55:51,1,1002,507,695,865,3069
22:55:52,1,0,0,0,0,0
22:55:53,1,0,0,0,0,0
22:55:54,1,0,0,0,0,0
22:55:55,1,1002,494,694,954,3144
22:55:56,1,1002,485,692,924,3103
22:55:57,1,1002,502,692,761,2957
22:55:58,1,1002,491,691,924,3108
22:55:59,1,0,0,0,0,0
22:56:00,1,1002,504,690,911,3107
22:56:01,1,0,0,0,0,0
22:56:02,1,0,0,0,0,0
22:56:03,1,0,0,0,0,0
22:56:04,1,0,0,0,0,0
22:56:05,1,0,0,0,0,0
22:56:06,1,1002,497,688,947,3134
22:56:07,1,1002,498,688,872,3060
22:56:08,1,0,0,0,0,0
22:56:09,1,0,0,0,0,0
22:56:10,1,0,0,0,0,0
22:56:11,1,0,0,0,0,0
22:56:12,1,0,0,0,0,0
22:56:13,1,0,0,0,0,0
22:56:14,1,0,0,0,0,0
22:56:15,1,0,0,0,0,0
22:56:16,1,0,0,0,0,0
22:56:17,1,1001,497,683,759,2940
22:56:18,1,1001,487,682,443,2613
22:56:19,1,0,0,0,0,0
22:56:20,1,1002,505,682,637,2826
22:56:21,1,0,0,0,0,0
22:56:22,1,0,0,0,0,0
22:56:23,1,0,0,0,0,0
22:56:24,1,0,0,0,0,0
22:56:25,1,0,0,0,0,0
22:56:26,1,1002,502,682,339,2525
22:56:27,1,1002,502,681,416,2601
22:56:28,1,0,0,0,0,0
22:56:29,1,0,0,0,0,0
22:56:30,1,1002,489,681,689,2861
22:56:31,1,1001,509,682,445,2637
22:56:32,1,1002,490,681,421,2594
22:56:33,1,1001,482,681,492,2656
22:56:34,1,1001,498,680,604,2783
22:56:35,1,1002,491,680,589,2762
22:56:36,1,1002,478,679,685,2844
22:56:37,1,1002,481,680,544,2707
22:56:38,1,1002,489,681,562,2734
22:56:39,1,1003,466,684,365,2518
22:56:40,1,1002,511,686,462,2661
22:56:41,1,1002,508,686,582,2778
22:56:42,1,1003,507,687,586,2783
22:56:43,1,1003,496,689,412,2600
22:56:44,1,1002,492,694,466,2654
22:56:45,1,1002,504,692,569,2767
22:56:46,1,1002,479,691,518,2690
22:56:47,1,1002,495,691,458,2646
22:56:48,1,1002,491,692,541,2726
22:56:49,1,1002,491,693,529,2715
22:56:50,1,1002,497,692,521,2712
22:56:51,1,1002,492,692,530,2716
22:56:52,1,1002,497,692,557,2748
22:56:53,1,1002,495,691,489,2677
22:56:54,1,1001,494,692,580,2767
22:56:55,1,1001,494,692,523,2710
22:56:56,1,1001,500,692,542,2735
22:56:57,1,1001,494,693,532,2720
22:56:58,1,1002,498,694,513,2707
22:56:59,1,1001,491,694,918,3104
22:57:00,1,1002,517,693,902,3114
22:57:01,1,1001,491,694,917,3103
22:57:02,1,1001,496,693,906,3096
22:57:03,1,1001,490,693,893,3077
22:57:04,1,1001,497,693,900,3091
22:57:05,1,1001,493,693,872,3059
22:57:06,1,1001,493,692,905,3091
22:57:07,1,1001,480,692,910,3083
22:57:08,1,1001,490,692,900,3083
22:57:09,1,1001,496,691,878,3066
22:57:10,1,1001,488,691,917,3097
22:57:11,1,1001,489,691,929,3110
22:57:12,1,1001,490,690,908,3089
22:57:13,1,1002,489,690,906,3087
22:57:14,1,1002,492,690,918,3102
22:57:15,1,1001,490,688,919,3098
22:57:16,1,1002,490,687,923,3102
22:57:17,1,1002,492,687,888,3069
22:57:18,1,1002,489,686,906,3083
22:57:19,1,0,0,0,0,0
22:57:20,1,1002,506,684,314,2506
22:57:21,1,0,0,0,0,0
22:57:22,1,0,0,0,0,0
22:57:23,1,1002,496,683,493,2674
22:57:24,1,1001,494,683,459,2637
22:57:25,1,1002,494,683,523,2702
22:57:26,1,1002,498,682,502,2684
22:57:27,1,1001,489,681,525,2696
22:57:28,1,1002,493,681,507,2683
22:57:29,1,1003,492,681,462,2638
22:57:30,1,1003,488,680,425,2596
22:57:31,1,1003,490,678,481,2652
22:57:32,1,1003,486,677,421,2587
22:57:33,1,1002,495,677,445,2619
22:57:34,1,0,0,0,0,0
22:57:35,1,1003,492,676,706,2877
22:57:36,1,1002,494,676,361,2533
22:57:37,1,1003,485,675,732,2895
22:57:38,1,1002,493,675,503,2673
22:57:39,1,1003,490,674,545,2712
22:57:40,1,1002,492,674,412,2580
22:57:41,1,1002,496,674,564,2736
22:57:42,1,1002,501,674,578,2755
22:57:43,1,1002,480,674,542,2698
22:57:44,1,1002,493,674,484,2653
22:57:45,1,1002,491,674,465,2632
22:57:46,1,1003,494,673,488,2658
22:57:47,1,1002,493,673,608,2776
22:57:48,1,1002,492,672,534,2700
22:57:49,1,1002,492,672,561,2727
22:57:50,1,1002,493,672,467,2634
22:57:51,1,1002,494,672,583,2751
22:57:52,1,1002,505,672,482,2661
22:57:53,1,1002,491,671,458,2622
22:57:54,1,1002,492,670,472,2636
22:57:55,1,1002,488,672,478,2640
22:57:56,1,1002,492,672,546,2712
22:57:57,1,1003,509,673,513,2698
22:57:58,1,1002,497,673,475,2647
22:57:59,1,1002,491,672,472,2637
22:58:00,1,1002,483,670,548,2703
22:58:01,1,1002,496,670,477,2645
22:58:02,1,1002,489,668,896,3055
22:58:03,1,1002,489,666,914,3071
22:58:04,1,1002,493,665,914,3074
22:58:05,1,1003,489,664,901,3057
22:58:06,1,1002,497,664,919,3082
22:58:07,1,1002,501,663,889,3055
22:58:08,1,1002,494,662,918,3076
22:58:09,1,1002,491,662,874,3029
22:58:10,1,1002,495,661,891,3049
22:58:11,1,1002,493,660,900,3055
22:58:12,1,1002,499,660,903,3064
22:58:13,1,1002,491,660,902,3055
22:58:14,1,1002,490,660,904,3056
22:58:15,1,1002,493,660,904,3059
22:58:16,1,1002,486,660,912,3060
22:58:17,1,1002,495,660,882,3039
22:58:18,1,1002,490,660,877,3029
22:58:19,1,1002,491,660,896,3049
22:58:20,1,1002,491,659,899,3051
22:58:21,1,1002,492,657,911,3062
22:58:22,1,1002,495,655,896,3048
22:58:23,1,1002,491,654,919,3066
22:58:24,1,1002,500,653,892,3047
22:58:25,1,1002,491,653,885,3031
22:58:26,1,1002,492,653,901,3048
22:58:27,1,1002,497,653,878,3030
22:58:28,1,1002,495,654,892,3043
22:58:29,1,1002,493,653,865,3013
22:58:30,1,1002,488,653,882,3025
22:58:31,1,1002,493,653,892,3040
22:58:32,1,1002,491,653,883,3029
22:58:33,1,1002,491,654,899,3046
22:58:34,1,1002,492,654,918,3066
22:58:35,1,1002,495,654,496,2647
22:58:36,1,1002,490,655,481,2628
22:58:37,1,1002,491,654,505,2652
22:58:38,1,1002,497,654,540,2693
22:58:39,1,1002,494,653,542,2691
22:58:40,1,1002,497,652,366,2517
22:58:41,1,1002,497,652,607,2758
22:58:42,1,1002,496,652,539,2689
22:58:43,1,1002,491,652,579,2724
22:58:44,1,1002,491,652,558,2703
22:58:45,1,1002,491,651,543,2687
22:58:46,1,1002,487,653,525,2667
22:58:47,1,1002,495,663,484,2644
22:58:48,1,1002,492,660,503,2657
22:58:49,1,1002,495,657,538,2692
22:58:50,1,1002,492,657,542,2693
22:58:51,1,1002,496,656,540,2694
22:58:52,1,1002,494,656,500,2652
22:58:53,1,1002,499,656,894,3051
22:58:54,1,1002,491,656,914,3063
22:58:55,1,1002,495,656,901,3054
22:58:56,1,1002,494,657,913,3066
22:58:57,1,1002,484,657,906,3049
22:58:58,1,1002,508,657,896,3063
22:58:59,1,1002,495,657,898,3052
22:59:00,1,1002,495,658,885,3040
22:59:01,1,1002,493,658,897,3050
22:59:02,1,1001,495,659,881,3036
22:59:03,1,1001,496,659,910,3066
22:59:04,1,1001,494,659,898,3052
22:59:05,1,1001,494,659,865,3019
22:59:06,1,1001,494,660,915,3070
22:59:07,1,1001,494,660,903,3058
22:59:08,1,1001,494,660,898,3053
22:59:09,1,1002,488,660,912,3062
22:59:10,1,1001,492,661,880,3034
22:59:11,1,1002,493,660,896,3051
22:59:12,1,1001,496,661,877,3035
22:59:13,1,1002,495,662,907,3066
22:59:14,1,1001,494,662,895,3052
22:59:15,1,1002,493,661,892,3048
22:59:16,1,1002,507,661,884,3054
22:59:17,1,1002,489,661,910,3062
22:59:18,1,1002,495,661,900,3058
22:59:19,1,1002,496,661,876,3035
22:59:20,1,1002,493,661,909,3065
22:59:21,1,1002,492,661,904,3059
22:59:22,1,1001,493,660,900,3054
22:59:23,1,1002,496,659,911,3068
22:59:24,1,1002,492,658,909,3061
22:59:25,1,1002,493,659,904,3058
22:59:26,1,1002,493,659,895,3049
22:59:27,1,1002,494,658,874,3028
22:59:28,1,1002,492,658,924,3076
22:59:29,1,1002,494,658,911,3065
22:59:30,1,1002,489,657,920,3068
22:59:31,1,1002,493,657,874,3026
22:59:32,1,0,0,0,0,0
22:59:33,1,1002,490,659,934,3085
22:59:34,1,1003,470,656,867,2996
22:59:35,1,1003,498,655,952,3108
22:59:36,1,1003,493,655,895,3046
22:59:37,1,1003,506,654,848,3011
22:59:38,1,1003,495,654,860,3012
22:59:39,1,1002,500,653,961,3116
22:59:40,1,1002,498,653,836,2989
22:59:41,1,1001,499,652,883,3035
22:59:42,1,1002,491,651,870,3014
22:59:43,1,1002,497,651,880,3030
22:59:44,1,1002,496,651,862,3011
22:59:45,1,1001,501,650,845,2997
22:59:46,1,0,0,0,0,0
22:59:47,1,0,0,0,0,0
22:59:48,1,0,0,0,0,0
22:59:49,1,1002,487,647,893,3029
22:59:50,1,1002,490,647,909,3048
22:59:51,1,1003,495,647,956,3101
22:59:52,1,1002,499,646,894,3041
22:59:53,1,0,0,0,0,0
22:59:54,1,1003,507,646,903,3059
22:59:55,1,1003,503,645,979,3130
22:59:56,1,1003,498,645,908,3054
22:59:57,1,1003,491,645,977,3116
22:59:58,1,0,0,0,0,0
22:59:59,1,1003,490,643,886,3022
23:00:00,1,1003,498,642,842,2985
23:00:01,1,1004,493,642,907,3046
23:00:02,1,1003,494,642,896,3035
23:00:03,1,1003,484,641,929,3057
23:00:04,1,0,0,0,0,0
23:00:05,1,0,0,0,0,0
23:00:06,1,1003,493,641,849,2986
23:00:07,1,1003,498,640,928,3069
23:00:08,1,1002,497,640,885,3024
23:00:09,1,1003,490,640,871,3004
23:00:10,1,1003,495,640,891,3029
23:00:11,1,1003,497,640,900,3040
23:00:12,1,1003,493,639,894,3029
23:00:13,1,1003,495,638,900,3036
23:00:14,1,1003,492,638,908,3041
23:00:15,1,0,0,0,0,0
23:00:16,1,1003,494,638,906,3041
23:00:17,1,1003,489,637,987,3116
23:00:18,1,0,0,0,0,0
23:00:19,1,1003,500,636,897,3036
23:00:20,1,0,0,0,0,0
23:00:21,1,1002,506,636,909,3053
23:00:22,1,1002,491,638,880,3011
23:00:23,1,0,0,0,0,0
23:00:24,1,1003,496,640,915,3054
23:00:25,1,1002,494,640,898,3034
23:00:26,1,1002,503,640,860,3005
23:00:27,1,1002,484,640,944,3070
23:00:28,1,1002,495,639,936,3072
23:00:29,1,1002,494,640,954,3090
23:00:30,1,0,0,0,0,0
23:00:31,1,0,0,0,0,0
23:00:32,1,1002,500,639,910,3051
23:00:33,1,0,0,0,0,0
23:00:34,1,1002,490,639,850,2981
23:00:35,1,1002,495,639,998,3134
23:00:36,1,1002,491,638,875,3006
23:00:37,1,0,0,0,0,0
23:00:38,1,0,0,0,0,0
23:00:39,1,1002,497,638,956,3093
23:00:40,1,0,0,0,0,0
23:00:41,1,1002,504,636,974,3116
23:00:42,1,1003,471,636,971,3081
23:00:43,1,1002,485,636,967,3090
23:00:44,1,1002,494,636,943,3075
23:00:45,1,0,0,0,0,0
23:00:46,1,0,0,0,0,0
23:00:47,1,1002,483,634,982,3101
23:00:48,1,1002,500,634,970,3106
23:00:49,1,1002,472,633,951,3058
23:00:50,1,1002,490,632,955,3079
23:00:51,1,1002,506,632,977,3117
23:00:52,1,1002,489,632,985,3108
23:00:53,1,1002,479,632,919,3032
23:00:54,1,1002,481,630,976,3089
23:00:55,1,1002,488,629,954,3073
23:00:56,1,1002,477,629,910,3018
23:00:57,1,0,0,0,0,0
23:00:58,1,0,0,0,0,0
23:00:59,1,1002,496,627,197,2322
23:01:00,1,1002,502,626,97,2227
23:01:01,1,1002,485,626,153,2266
23:01:02,1,1002,480,625,132,2239
23:01:03,1,1001,482,625,55,2163
23:01:04,1,1002,510,625,31,2168
23:01:05,1,1003,483,624,152,2262
23:01:06,1,1002,484,624,78,2188
23:01:07,1,1001,489,623,159,2272
23:01:08,1,1001,483,623,71,2178
23:01:09,1,0,0,0,0,0
23:01:10,1,1002,467,623,146,2238
23:01:11,1,1002,447,622,97,2168
23:01:12,1,1002,531,622,108,2263
23:01:13,1,1001,468,622,160,2251
23:01:14,1,1000,497,620,133,2250
23:01:15,1,0,0,0,0,0
23:01:16,1,1002,481,618,143,2244
23:01:17,1,1001,488,618,105,2212
23:01:18,1,1002,491,617,94,2204
23:01:19,1,1002,469,616,3,2090
23:01:20,1,1001,491,615,0,2107
23:01:21,1,0,0,0,0,0
23:01:22,1,1000,491,613,2,2106
23:01:23,1,1001,505,612,1,2119
23:01:24,1,1002,490,613,4,2109
23:01:25,1,1000,498,611,3,2112
23:01:26,1,1002,509,611,5,2127
23:01:27,1,1001,492,610,1,2104
23:01:28,1,1002,496,609,0,2107
23:01:29,1,0,0,0,0,0
23:01:30,1,1000,499,608,3,2110
23:01:31,1,0,0,0,0,0
23:01:32,1,1001,469,607,1,2078
23:01:33,1,1001,440,607,3,2051
23:01:34,1,1001,497,606,2,2106
23:01:35,1,1000,495,606,2,2103
23:01:36,1,0,0,0,0,0
23:01:37,1,1001,470,605,2,2078
23:01:38,1,1000,474,604,4,2082
23:01:39,1,1001,492,604,2,2099
23:01:40,1,1001,509,604,2,2116
23:01:41,1,1002,472,603,4,2081
23:01:42,1,1001,476,603,0,2080
23:01:43,1,1001,492,602,2,2097
23:01:44,1,1001,509,602,2,2114
23:01:45,1,1001,490,601,2,2094
23:01:46,1,1001,520,601,2,2124
23:01:47,1,1001,489,600,2,2092
23:01:48,1,1001,499,599,2,2101
23:01:49,1,1001,505,599,2,2107
23:01:50,1,1000,480,599,3,2082
23:01:51,1,1001,495,599,2,2097
23:01:52,1,1000,494,598,2,2094
23:01:53,1,1001,527,597,0,2125
23:01:54,1,1001,484,597,1,2083
23:01:55,1,1001,504,597,0,2102
23:01:56,1,1000,511,597,0,2108
23:01:57,1,1001,470,596,1,2068
23:01:58,1,1001,485,596,1,2083
23:01:59,1,1001,500,595,0,2096
23:02:00,1,1001,505,595,1,2102
23:02:01,1,1000,483,594,1,2078
23:02:02,1,1001,484,594,0,2079
23:02:03,1,1001,489,594,0,2084
23:02:04,1,1001,492,593,1,2087
23:02:05,1,1001,485,593,1,2080
23:02:06,1,1000,476,593,0,2069
23:02:07,1,1000,478,593,0,2071
23:02:08,1,1001,488,592,0,2081
23:02:09,1,1000,487,592,0,2079
23:02:10,1,1001,479,592,1,2073
23:02:11,1,1003,496,592,0,2091
23:02:12,1,1000,499,592,0,2091
23:02:13,1,1001,495,592,1,2089
23:02:14,1,1002,485,592,0,2079
23:02:15,1,1001,496,590,1,2088
23:02:16,1,1002,519,589,0,2110
23:02:17,1,1002,500,589,1,2092
23:02:18,1,0,0,0,0,0
23:02:19,1,1002,491,589,2,2084
23:02:20,1,1001,499,588,1,2089
23:02:21,1,1002,507,588,1,2098
23:02:22,1,1002,492,588,1,2083
23:02:23,1,1001,494,587,0,2082
23:02:24,1,1001,494,586,1,2082
23:02:25,1,1001,497,586,2,2086
23:02:26,1,1001,495,585,1,2082
23:02:27,1,1001,489,584,0,2074
23:02:28,1,1001,486,584,0,2071
23:02:29,1,1001,501,584,2,2088
23:02:30,1,1001,496,584,0,2081
23:02:31,1,1002,493,583,1,2079
23:02:32,1,1001,497,583,1,2082
23:02:33,1,1001,492,582,0,2075
23:02:34,1,1001,494,582,1,2078
23:02:35,1,1001,490,581,1,2073
23:02:36,1,1001,494,581,0,2076
23:02:37,1,1002,495,581,1,2079
23:02:38,1,1001,490,581,0,2072
23:02:39,1,0,0,0,0,0
23:02:40,1,1001,491,580,2,2074
23:02:41,1,1002,496,580,1,2079
23:02:42,1,0,0,0,0,0
23:02:43,1,1001,497,579,0,2077
23:02:44,1,1001,492,579,0,2072
23:02:45,1,1002,500,579,1,2082
23:02:46,1,0,0,0,0,0
23:02:47,1,1002,496,578,0,2076
23:02:48,1,1002,496,578,2,2078
23:02:49,1,1002,494,578,2,2076
23:02:50,1,1001,499,577,0,2077
23:02:51,1,1002,493,577,0,2072
23:02:52,1,1001,499,578,1,2079
23:02:53,1,1001,502,577,2,2082
23:02:54,1,0,0,0,0,0
23:02:55,1,1002,488,577,2,2069
23:02:56,1,1002,464,576,1,2043
23:02:57,1,1002,489,576,1,2068
23:02:58,1,1002,490,576,0,2068
23:02:59,1,1002,500,576,0,2078
23:03:00,1,1002,493,576,2,2073
23:03:01,1,1002,493,575,0,2070
23:03:02,1,1002,509,575,1,2087
23:03:03,1,0,0,0,0,0
23:03:04,1,1002,497,575,1,2075
23:03:05,1,1002,496,574,1,2073
23:03:06,1,1001,507,573,1,2082
23:03:07,1,1001,489,573,0,2063
23:03:08,1,1001,495,572,0,2068
23:03:09,1,1001,496,572,1,2070
23:03:10,1,1001,498,572,1,2072
23:03:11,1,1002,491,572,1,2066
23:03:12,1,1002,496,571,0,2069
23:03:13,1,1001,498,571,1,2071
23:03:14,1,1001,496,571,1,2069
23:03:15,1,1001,497,570,0,2068
23:03:16,1,1001,494,570,1,2066
23:03:17,1,1002,495,570,0,2067
23:03:18,1,1002,492,570,0,2064
23:03:19,1,1002,492,570,1,2065
23:03:20,1,1002,497,570,1,2070
23:03:21,1,1002,484,570,1,2057
23:03:22,1,1002,499,570,0,2071
23:03:23,1,1002,492,570,1,2065
23:03:24,1,1002,496,570,0,2068
23:03:25,1,1002,490,569,1,2062
23:03:26,1,1002,499,569,1,2071
23:03:27,1,1001,494,569,1,2065
23:03:28,1,1002,494,569,1,2066
23:03:29,1,1002,488,569,1,2060
23:03:30,1,1002,498,569,0,2069
23:03:31,1,1002,499,569,1,2071
23:03:32,1,1002,496,569,1,2068
23:03:33,1,1002,490,568,0,2060
23:03:34,1,1002,496,568,0,2066
23:03:35,1,1002,490,568,1,2061
23:03:36,1,1002,496,568,0,2066
23:03:37,1,1002,499,568,0,2069
23:03:38,1,0,0,0,0,0
23:03:39,1,1002,492,568,0,2062
23:03:40,1,1002,487,568,1,2058
23:03:41,1,1002,494,568,1,2065
23:03:42,1,1002,496,567,1,2066
23:03:43,1,1002,492,567,1,2062
23:03:44,1,1001,496,567,1,2065
23:03:45,1,1001,491,567,1,2060
23:03:46,1,0,0,0,0,0
23:03:47,1,1001,493,567,1,2062
23:03:48,1,1001,491,567,1,2060
23:03:49,1,1002,488,567,1,2058
23:03:50,1,1002,496,567,0,2065
23:03:51,1,1002,498,567,1,2068
23:03:52,1,1002,493,567,1,2063
23:03:53,1,1002,495,566,1,2064
23:03:54,1,1002,497,566,1,2066
23:03:55,1,1002,516,566,1,2085
23:03:56,1,1002,565,566,0,2133
23:03:57,1,1002,495,566,0,2063
23:03:58,1,0,0,0,0,0
23:03:59,1,1002,495,566,1,2064
23:04:00,1,1002,493,566,1,2062
23:04:01,1,1002,498,566,0,2066
23:04:02,1,1002,497,566,0,2065
23:04:03,1,1002,494,565,0,2061
23:04:04,1,1003,496,565,0,2064
23:04:05,1,1003,497,565,1,2066
23:04:06,1,1003,488,565,0,2056
23:04:07,1,1003,498,565,2,2068
23:04:08,1,1002,494,565,1,2062
23:04:09,1,1003,500,564,1,2068
23:04:10,1,1003,488,564,1,2056
23:04:11,1,1002,496,564,0,2062
23:04:12,1,1003,485,564,1,2053
23:04:13,1,1003,507,564,1,2075
23:04:14,1,1002,494,564,0,2060
23:04:15,1,1002,500,564,1,2067
23:04:16,1,0,0,0,0,0
23:04:17,1,1002,497,564,1,2064
23:04:18,1,1003,494,564,0,2061
23:04:19,1,1003,494,563,1,2061
23:04:20,1,0,0,0,0,0
23:04:21,1,1002,497,563,1,2063
23:04:22,1,1002,490,563,1,2056
23:04:23,1,1003,502,563,2,2070
23:04:24,1,1002,494,563,0,2059
23:04:25,1,1002,494,563,1,2060
23:04:26,1,1002,493,563,0,2058
23:04:27,1,1002,489,563,1,2055
23:04:28,1,1002,495,563,1,2061
23:04:29,1,1002,494,562,0,2058
23:04:30,1,1002,503,562,0,2067
23:04:31,1,1003,488,562,1,2054
23:04:32,1,0,0,0,0,0
23:04:33,1,1002,496,562,1,2061
23:04:34,1,1002,494,562,1,2059
23:04:35,1,0,0,0,0,0
23:04:36,1,0,0,0,0,0
23:04:37,1,1002,500,562,1,2065
23:04:38,1,1002,497,561,1,2061
23:04:39,1,1002,496,561,2,2061
23:04:40,1,1002,490,561,0,2053
23:04:41,1,1002,495,561,1,2059
23:04:42,1,1002,496,561,1,2060
23:04:43,1,1002,495,561,0,2058
23:04:44,1,1001,489,561,1,2052
23:04:45,1,1002,490,561,1,2054
23:04:46,1,0,0,0,0,0
23:04:47,1,1002,488,560,1,2051
23:04:48,1,1001,500,560,1,2062
23:04:49,1,1002,486,560,1,2049
23:04:50,1,1001,494,560,0,2055
23:04:51,1,1002,500,560,2,2064
23:04:52,1,1002,495,560,1,2058
23:04:53,1,1002,492,560,1,2055
23:04:54,1,0,0,0,0,0
23:04:55,1,1002,489,560,0,2051
23:04:56,1,1002,495,559,0,2056
23:04:57,1,1002,503,559,2,2066
23:04:58,1,0,0,0,0,0
23:04:59,1,1002,497,559,0,2058
23:05:00,1,1002,494,559,1,2056
23:05:01,1,1002,494,559,1,2056
23:05:02,1,1001,493,559,0,2053
23:05:03,1,1002,500,559,1,2062
23:05:04,1,0,0,0,0,0
23:05:05,1,1001,496,559,1,2057
23:05:06,1,0,0,0,0,0
23:05:07,1,1001,494,558,1,2054
23:05:08,1,1002,494,558,1,2055
23:05:09,1,1002,503,558,2,2065
23:05:10,1,1002,490,558,1,2051
23:05:11,1,0,0,0,0,0
23:05:12,1,1002,491,557,1,2051
23:05:13,1,0,0,0,0,0
23:05:14,1,1002,499,557,1,2059
23:05:15,1,1001,492,557,0,2050
23:05:16,1,1002,486,557,1,2046
23:05:17,1,1001,500,557,0,2058
23:05:18,1,1002,494,557,2,2055
23:05:19,1,1002,490,557,1,2050
23:05:20,1,1002,490,557,1,2050
23:05:21,1,1002,499,557,0,2058
23:05:22,1,1002,498,557,1,2058
23:05:23,1,1002,496,557,1,2056
23:05:24,1,1002,489,556,0,2047
23:05:25,1,1002,481,556,1,2040
23:05:26,1,1002,493,556,0,2051
23:05:27,1,0,0,0,0,0
23:05:28,1,1002,512,556,1,2071
23:05:29,1,1002,492,555,1,2050
23:05:30,1,1002,494,555,2,2053
23:05:31,1,1002,510,555,1,2068
23:05:32,1,1002,494,555,1,2052
23:05:33,1,1002,498,555,1,2056
23:05:34,1,1002,493,555,0,2050
23:05:35,1,0,0,0,0,0
23:05:36,1,1001,491,555,2,2049
23:05:37,1,1002,495,554,1,2052
23:05:38,1,1002,497,554,1,2054
23:05:39,1,1001,496,554,1,2052
23:05:40,1,1001,493,554,1,2049
23:05:41,1,1001,496,554,1,2052
23:05:42,1,1001,492,554,1,2048
23:05:43,1,1002,495,554,1,2052
23:05:44,1,1002,493,554,0,2049
23:05:45,1,1002,495,554,0,2051
23:05:46,1,1001,492,554,0,2047
23:05:47,1,1002,495,554,1,2052
23:05:48,1,1002,488,554,1,2045
23:05:49,1,1002,489,554,1,2046
23:05:50,1,1002,487,554,1,2044
23:05:51,1,1001,496,553,1,2051
23:05:52,1,1002,497,553,0,2052
23:05:53,1,1002,492,553,1,2048
23:05:54,1,1001,484,553,0,2038
23:05:55,1,1001,492,553,0,2046
23:05:56,1,1001,494,553,0,2048
23:05:57,1,0,0,0,0,0
23:05:58,1,1002,494,553,0,2049
23:05:59,1,1001,495,553,2,2051
23:06:00,1,1002,490,552,1,2045
23:06:01,1,1001,484,552,1,2038
23:06:02,1,1002,495,552,2,2051
23:06:03,1,1001,499,552,1,2053
23:06:04,1,1001,501,552,0,2054
23:06:05,1,1001,496,552,1,2050
23:06:06,1,1002,494,552,0,2048
23:06:07,1,1001,492,552,1,2046
23:06:08,1,1001,491,551,2,2045
23:06:09,1,1002,494,551,0,2047
23:06:10,1,1002,493,551,1,2047
23:06:11,1,1001,494,551,1,2047
23:06:12,1,0,0,0,0,0
23:06:13,1,1001,497,551,0,2049
23:06:14,1,1002,494,550,0,2046
23:06:15,1,1001,496,550,0,2047
23:06:16,1,1002,497,550,1,2050
23:06:17,1,1002,494,550,0,2046
23:06:18,1,1001,494,550,1,2046
23:06:19,1,1001,495,550,1,2047
23:06:20,1,1001,496,550,1,2048
23:06:21,1,1001,493,550,0,2044
23:06:22,1,1001,492,550,0,2043
23:06:23,1,1001,494,550,1,2046
23:06:24,1,1001,493,550,1,2045
23:06:25,1,1001,495,550,0,2046
23:06:26,1,1001,489,549,1,2040
23:06:27,1,1001,497,549,1,2048
23:06:28,1,1001,489,549,0,2039
23:06:29,1,1001,493,549,0,2043
23:06:30,1,0,0,0,0,0
23:06:31,1,1001,506,549,1,2057
23:06:32,1,1001,489,549,1,2040
23:06:33,1,0,0,0,0,0
23:06:34,1,1001,496,549,1,2047
23:06:35,1,1001,490,549,2,2042
23:06:36,1,1001,498,549,1,2049
23:06:37,1,1001,489,548,1,2039
23:06:38,1,1001,494,548,0,2043
23:06:39,1,1001,497,548,1,2047
23:06:40,1,1001,491,548,1,2041
23:06:41,1,1001,486,548,1,2036
23:06:42,1,1001,495,548,1,2045
23:06:43,1,1001,493,548,1,2043
23:06:44,1,1001,498,548,2,2049
23:06:45,1,1002,476,548,2,2028
23:06:46,1,1001,493,548,0,2042
23:06:47,1,1001,494,548,1,2044
23:06:48,1,1001,491,548,1,2041
23:06:49,1,1001,479,548,1,2029
23:06:50,1,1001,494,547,1,2043
23:06:51,1,1001,493,547,1,2042
23:06:52,1,1002,489,547,0,2038
23:06:53,1,1001,499,547,1,2048
23:06:54,1,1001,496,547,0,2044
23:06:55,1,1001,487,547,1,2036
23:06:56,1,1001,499,547,2,2049
23:06:57,1,1001,492,547,1,2041
23:06:58,1,1001,517,547,1,2066
23:06:59,1,1001,488,547,1,2037
23:07:00,1,1001,502,547,1,2051
23:07:01,1,1001,491,547,1,2040
23:07:02,1,1001,488,547,1,2037
23:07:03,1,1001,496,547,1,2045
23:07:04,1,1001,493,547,2,2043
23:07:05,1,1013,493,538,0,2044
22:50:41,2,0,0,0,0,0
22:50:42,2,1005,492,534,0,2031
22:50:43,2,1005,515,535,0,2055
22:50:44,2,1004,491,534,0,2029
22:50:45,2,1004,492,534,0,2030
22:50:46,2,1004,488,535,0,2027
22:50:47,2,1004,493,535,0,2032
22:50:48,2,1004,493,535,0,2032
22:50:49,2,1004,496,535,0,2035
22:50:50,2,1002,484,535,0,2021
22:50:51,2,1002,471,535,0,2008
22:50:52,2,1002,484,535,0,2021
22:50:53,2,1001,494,535,0,2030
22:50:54,2,1001,486,535,0,2022
22:50:55,2,0,0,0,0,0
22:50:56,2,1003,489,535,0,2027
22:50:57,2,1001,492,535,0,2028
22:50:58,2,1001,496,535,0,2032
22:50:59,2,1002,486,535,0,2023
22:51:00,2,1002,538,535,0,2075
22:51:01,2,1001,514,535,0,2050
22:51:02,2,1002,498,535,0,2035
22:51:03,2,1003,492,535,0,2030
22:51:04,2,1004,481,535,0,2020
22:51:05,2,1002,489,535,0,2026
22:51:06,2,1003,512,535,0,2050
22:51:07,2,1002,488,535,0,2025
22:51:08,2,1002,498,535,0,2035
22:51:09,2,1003,498,535,0,2036
22:51:10,2,0,0,0,0,0
22:51:11,2,0,0,0,0,0
22:51:12,2,0,0,0,0,0
22:51:13,2,0,0,0,0,0
22:51:14,2,1003,498,535,0,2036
22:51:15,2,0,0,0,0,0
22:51:16,2,1003,502,535,0,2040
22:51:17,2,0,0,0,0,0
22:51:18,2,0,0,0,0,0
22:51:19,2,0,0,0,0,0
22:51:20,2,1003,484,535,0,2022
22:51:21,2,0,0,0,0,0
22:51:22,2,0,0,0,0,0
22:51:23,2,1001,496,535,0,2032
22:51:24,2,1002,490,535,0,2027
22:51:25,2,1002,486,536,0,2024
22:51:26,2,0,0,0,0,0
22:51:27,2,1001,505,535,0,2041
22:51:28,2,1001,494,535,0,2030
22:51:29,2,1001,500,535,0,2036
22:51:30,2,1001,494,535,0,2030
22:51:31,2,1002,486,535,0,2023
22:51:32,2,1001,488,535,0,2024
22:51:33,2,1002,486,535,0,2023
22:51:34,2,1001,477,535,0,2013
22:51:35,2,1002,477,535,0,2014
22:51:36,2,1002,479,535,0,2016
22:51:37,2,1002,482,535,0,2019
22:51:38,2,1002,493,535,170,2200
22:51:39,2,1002,485,536,132,2155
22:51:40,2,1002,482,536,107,2127
22:51:41,2,1002,482,536,517,2537
22:51:42,2,1002,488,536,413,2439
22:51:43,2,1001,489,536,364,2390
22:51:44,2,1002,486,536,422,2446
22:51:45,2,1002,492,536,552,2582
22:51:46,2,1002,489,536,494,2521
22:51:47,2,1001,498,536,562,2597
22:51:48,2,0,0,0,0,0
22:51:49,2,1002,488,536,535,2561
22:51:50,2,1000,490,536,431,2457
22:51:51,2,1001,484,536,491,2512
22:51:52,2,0,0,0,0,0
22:51:53,2,1001,486,536,458,2481
22:51:54,2,1002,495,538,539,2574
22:51:55,2,1002,490,541,474,2507
22:51:56,2,1002,497,543,475,2517
22:51:57,2,1003,481,546,514,2544
22:51:58,2,1005,486,550,643,2684
22:51:59,2,1006,489,566,524,2585
22:52:00,2,1006,505,575,436,2522
22:52:01,2,1005,503,588,434,2530
22:52:02,2,1004,530,596,469,2599
22:52:03,2,1004,491,602,537,2634
22:52:04,2,1004,493,609,511,2617
22:52:05,2,1004,478,616,391,2489
22:52:06,2,1003,482,632,454,2571
22:52:07,2,1003,479,631,511,2624
22:52:08,2,1004,498,634,311,2447
22:52:09,2,0,0,0,0,0
22:52:10,2,1003,531,645,557,2736
22:52:11,2,1002,496,656,513,2667
22:52:12,2,1002,387,659,356,2404
22:52:13,2,1003,488,661,496,2648
22:52:14,2,1002,484,666,491,2643
22:52:15,2,1002,488,667,587,2744
22:52:16,2,1002,494,674,453,2623
22:52:17,2,1001,491,681,433,2606
22:52:18,2,1002,481,687,519,2689
22:52:19,2,1000,495,691,471,2657
22:52:20,2,999,486,692,479,2656
22:52:21,2,1000,501,692,510,2703
22:52:22,2,1000,498,693,528,2719
22:52:23,2,1000,473,696,455,2624
22:52:24,2,1000,488,697,487,2672
22:52:25,2,1000,480,698,542,2720
22:52:26,2,1000,494,700,463,2657
22:52:27,2,1000,497,701,420,2618
22:52:28,2,1001,474,703,533,2711
22:52:29,2,1001,515,708,490,2714
22:52:30,2,1001,476,710,619,2806
22:52:31,2,1000,513,714,316,2543
22:52:32,2,999,493,715,443,2650
22:52:33,2,999,500,715,842,3056
22:52:34,2,1000,513,718,901,3132
22:52:35,2,999,466,719,773,2957
22:52:36,2,999,501,721,876,3097
22:52:37,2,0,0,0,0,0
22:52:38,2,1000,516,723,926,3165
22:52:39,2,0,0,0,0,0
22:52:40,2,999,488,727,877,3091
22:52:41,2,999,489,727,922,3137
22:52:42,2,999,484,729,854,3066
22:52:43,2,999,518,731,903,3151
22:52:44,2,999,494,733,892,3118
22:52:45,2,999,455,734,859,3047
22:52:46,2,999,499,734,790,3022
22:52:47,2,999,479,735,856,3069
22:52:48,2,998,484,735,911,3128
22:52:49,2,999,513,740,891,3143
22:52:50,2,998,500,742,878,3118
22:52:51,2,998,481,744,898,3121
22:52:52,2,999,507,746,874,3126
22:52:53,2,999,483,749,957,3188
22:52:54,2,998,492,749,861,3100
22:52:55,2,999,501,751,843,3094
22:52:56,2,998,496,752,900,3146
22:52:57,2,998,489,754,875,3116
22:52:58,2,997,477,755,918,3147
22:52:59,2,0,0,0,0,0
22:53:00,2,0,0,0,0,0
22:53:01,2,997,495,756,912,3160
22:53:02,2,997,474,757,794,3022
22:53:03,2,998,527,759,875,3159
22:53:04,2,999,485,761,911,3156
22:53:05,2,998,487,762,782,3029
22:53:06,2,998,479,762,901,3140
22:53:07,2,998,473,765,860,3096
22:53:08,2,998,467,766,907,3138
22:53:09,2,998,498,768,901,3165
22:53:10,2,998,503,771,899,3171
22:53:11,2,1000,505,773,864,3142
22:53:12,2,999,492,776,920,3187
22:53:13,2,0,0,0,0,0
22:53:14,2,999,496,781,847,3123
22:53:15,2,0,0,0,0,0
22:53:16,2,0,0,0,0,0
22:53:17,2,0,0,0,0,0
22:53:18,2,0,0,0,0,0
22:53:19,2,0,0,0,0,0
22:53:20,2,0,0,0,0,0
22:53:21,2,0,0,0,0,0
22:53:22,2,0,0,0,0,0
22:53:23,2,0,0,0,0,0
22:53:24,2,0,0,0,0,0
22:53:25,2,0,0,0,0,0
22:53:26,2,0,0,0,0,0
22:53:27,2,0,0,0,0,0
22:53:28,2,0,0,0,0,0
22:53:29,2,0,0,0,0,0
22:53:30,2,0,0,0,0,0
22:53:31,2,0,0,0,0,0
22:53:32,2,0,0,0,0,0
22:53:33,2,0,0,0,0,0
22:53:34,2,0,0,0,0,0
22:53:35,2,0,0,0,0,0
22:53:36,2,0,0,0,0,0
22:53:37,2,0,0,0,0,0
22:53:38,2,0,0,0,0,0
22:53:39,2,0,0,0,0,0
22:53:40,2,0,0,0,0,0
22:53:41,2,0,0,0,0,0
22:53:42,2,0,0,0,0,0
22:53:43,2,0,0,0,0,0
22:53:44,2,0,0,0,0,0
22:53:45,2,0,0,0,0,0
22:53:46,2,0,0,0,0,0
22:53:47,2,0,0,0,0,0
22:53:48,2,0,0,0,0,0
22:53:49,2,0,0,0,0,0
22:53:50,2,0,0,0,0,0
22:53:51,2,0,0,0,0,0
22:53:52,2,0,0,0,0,0
22:53:53,2,0,0,0,0,0
22:53:54,2,0,0,0,0,0
22:53:55,2,0,0,0,0,0
22:53:56,2,0,0,0,0,0
22:53:57,2,0,0,0,0,0
22:53:58,2,0,0,0,0,0
22:53:59,2,0,0,0,0,0
22:54:00,2,0,0,0,0,0
22:54:01,2,0,0,0,0,0
22:54:02,2,0,0,0,0,0
22:54:03,2,0,0,0,0,0
22:54:04,2,0,0,0,0,0
22:54:05,2,0,0,0,0,0
22:54:06,2,0,0,0,0,0
22:54:07,2,0,0,0,0,0
22:54:08,2,0,0,0,0,0
22:54:09,2,0,0,0,0,0
22:54:10,2,0,0,0,0,0
22:54:11,2,0,0,0,0,0
22:54:12,2,0,0,0,0,0
22:54:13,2,0,0,0,0,0
22:54:14,2,0,0,0,0,0
22:54:15,2,0,0,0,0,0
22:54:16,2,0,0,0,0,0
22:54:17,2,0,0,0,0,0
22:54:18,2,0,0,0,0,0
22:54:19,2,0,0,0,0,0
22:54:20,2,0,0,0,0,0
22:54:21,2,0,0,0,0,0
22:54:22,2,0,0,0,0,0
22:54:23,2,0,0,0,0,0
22:54:24,2,0,0,0,0,0
22:54:25,2,0,0,0,0,0
22:54:26,2,0,0,0,0,0
22:54:27,2,0,0,0,0,0
22:54:28,2,0,0,0,0,0
22:54:29,2,0,0,0,0,0
22:54:30,2,0,0,0,0,0
22:54:31,2,0,0,0,0,0
22:54:32,2,0,0,0,0,0
22:54:33,2,0,0,0,0,0
22:54:34,2,0,0,0,0,0
22:54:35,2,0,0,0,0,0
22:54:36,2,0,0,0,0,0
22:54:37,2,0,0,0,0,0
22:54:38,2,0,0,0,0,0
22:54:39,2,0,0,0,0,0
22:54:40,2,0,0,0,0,0
22:54:41,2,0,0,0,0,0
22:54:42,2,0,0,0,0,0
22:54:43,2,0,0,0,0,0
22:54:44,2,0,0,0,0,0
22:54:45,2,0,0,0,0,0
22:54:46,2,0,0,0,0,0
22:54:47,2,0,0,0,0,0
22:54:48,2,0,0,0,0,0
22:54:49,2,0,0,0,0,0
22:54:50,2,0,0,0,0,0
22:54:51,2,0,0,0,0,0
22:54:52,2,0,0,0,0,0
22:54:53,2,0,0,0,0,0
22:54:54,2,0,0,0,0,0
22:54:55,2,0,0,0,0,0
22:54:56,2,0,0,0,0,0
22:54:57,2,0,0,0,0,0
22:54:58,2,0,0,0,0,0
22:54:59,2,0,0,0,0,0
22:55:00,2,0,0,0,0,0
22:55:01,2,0,0,0,0,0
22:55:02,2,0,0,0,0,0
22:55:03,2,0,0,0,0,0
22:55:04,2,0,0,0,0,0
22:55:05,2,0,0,0,0,0
22:55:06,2,0,0,0,0,0
22:55:07,2,0,0,0,0,0
22:55:08,2,0,0,0,0,0
22:55:09,2,0,0,0,0,0
22:55:10,2,0,0,0,0,0
22:55:11,2,0,0,0,0,0
22:55:12,2,0,0,0,0,0
22:55:13,2,0,0,0,0,0
22:55:14,2,0,0,0,0,0
22:55:15,2,0,0,0,0,0
22:55:16,2,0,0,0,0,0
22:55:17,2,0,0,0,0,0
22:55:18,2,0,0,0,0,0
22:55:19,2,0,0,0,0,0
22:55:20,2,0,0,0,0,0
22:55:21,2,0,0,0,0,0
22:55:22,2,0,0,0,0,0
22:55:23,2,0,0,0,0,0
22:55:24,2,0,0,0,0,0
22:55:25,2,0,0,0,0,0
22:55:26,2,0,0,0,0,0
22:55:27,2,0,0,0,0,0
22:55:28,2,0,0,0,0,0
22:55:29,2,0,0,0,0,0
22:55:30,2,0,0,0,0,0
22:55:31,2,0,0,0,0,0
22:55:32,2,0,0,0,0,0
22:55:33,2,0,0,0,0,0
22:55:34,2,0,0,0,0,0
22:55:35,2,0,0,0,0,0
22:55:36,2,0,0,0,0,0
22:55:37,2,0,0,0,0,0
22:55:38,2,0,0,0,0,0
22:55:39,2,0,0,0,0,0
22:55:40,2,0,0,0,0,0
22:55:41,2,0,0,0,0,0
22:55:42,2,0,0,0,0,0
22:55:43,2,0,0,0,0,0
22:55:44,2,0,0,0,0,0
22:55:45,2,0,0,0,0,0
22:55:46,2,0,0,0,0,0
22:55:47,2,0,0,0,0,0
22:55:48,2,0,0,0,0,0
22:55:49,2,0,0,0,0,0
22:55:50,2,0,0,0,0,0
22:55:51,2,0,0,0,0,0
22:55:52,2,0,0,0,0,0
22:55:53,2,0,0,0,0,0
22:55:54,2,0,0,0,0,0
22:55:55,2,0,0,0,0,0
22:55:56,2,0,0,0,0,0
22:55:57,2,0,0,0,0,0
22:55:58,2,0,0,0,0,0
22:55:59,2,0,0,0,0,0
22:56:00,2,0,0,0,0,0
22:56:01,2,0,0,0,0,0
22:56:02,2,0,0,0,0,0
22:56:03,2,0,0,0,0,0
22:56:04,2,0,0,0,0,0
22:56:05,2,0,0,0,0,0
22:56:06,2,0,0,0,0,0
22:56:07,2,0,0,0,0,0
22:56:08,2,0,0,0,0,0
22:56:09,2,0,0,0,0,0
22:56:10,2,0,0,0,0,0
22:56:11,2,0,0,0,0,0
22:56:12,2,0,0,0,0,0
22:56:13,2,0,0,0,0,0
22:56:14,2,0,0,0,0,0
22:56:15,2,0,0,0,0,0
22:56:16,2,0,0,0,0,0
22:56:17,2,0,0,0,0,0
22:56:18,2,0,0,0,0,0
22:56:19,2,0,0,0,0,0
22:56:20,2,0,0,0,0,0
22:56:21,2,0,0,0,0,0
22:56:22,2,0,0,0,0,0
22:56:23,2,0,0,0,0,0
22:56:24,2,0,0,0,0,0
22:56:25,2,0,0,0,0,0
22:56:26,2,0,0,0,0,0
22:56:27,2,0,0,0,0,0
22:56:28,2,0,0,0,0,0
22:56:29,2,0,0,0,0,0
22:56:30,2,0,0,0,0,0
22:56:31,2,0,0,0,0,0
22:56:32,2,0,0,0,0,0
22:56:33,2,0,0,0,0,0
22:56:34,2,0,0,0,0,0
22:56:35,2,0,0,0,0,0
22:56:36,2,0,0,0,0,0
22:56:37,2,0,0,0,0,0
22:56:38,2,0,0,0,0,0
22:56:39,2,0,0,0,0,0
22:56:40,2,0,0,0,0,0
22:56:41,2,0,0,0,0,0
22:56:42,2,0,0,0,0,0
22:56:43,2,0,0,0,0,0
22:56:44,2,0,0,0,0,0
22:56:45,2,0,0,0,0,0
22:56:46,2,0,0,0,0,0
22:56:47,2,0,0,0,0,0
22:56:48,2,0,0,0,0,0
22:56:49,2,0,0,0,0,0
22:56:50,2,0,0,0,0,0
22:56:51,2,0,0,0,0,0
22:56:52,2,0,0,0,0,0
22:56:53,2,0,0,0,0,0
22:56:54,2,0,0,0,0,0
22:56:55,2,0,0,0,0,0
22:56:56,2,0,0,0,0,0
22:56:57,2,0,0,0,0,0
22:56:58,2,0,0,0,0,0
22:56:59,2,0,0,0,0,0
22:57:00,2,0,0,0,0,0
22:57:01,2,0,0,0,0,0
22:57:02,2,0,0,0,0,0
22:57:03,2,0,0,0,0,0
22:57:04,2,0,0,0,0,0
22:57:05,2,0,0,0,0,0
22:57:06,2,0,0,0,0,0
22:57:07,2,0,0,0,0,0
22:57:08,2,0,0,0,0,0
22:57:09,2,0,0,0,0,0
22:57:10,2,0,0,0,0,0
22:57:11,2,0,0,0,0,0
22:57:12,2,0,0,0,0,0
22:57:13,2,0,0,0,0,0
22:57:14,2,0,0,0,0,0
22:57:15,2,0,0,0,0,0
22:57:16,2,0,0,0,0,0
22:57:17,2,0,0,0,0,0
22:57:18,2,0,0,0,0,0
22:57:19,2,0,0,0,0,0
22:57:20,2,0,0,0,0,0
22:57:21,2,0,0,0,0,0
22:57:22,2,0,0,0,0,0
22:57:23,2,0,0,0,0,0
22:57:24,2,0,0,0,0,0
22:57:25,2,0,0,0,0,0
22:57:26,2,0,0,0,0,0
22:57:27,2,0,0,0,0,0
22:57:28,2,0,0,0,0,0
22:57:29,2,0,0,0,0,0
22:57:30,2,0,0,0,0,0
22:57:31,2,0,0,0,0,0
22:57:32,2,0,0,0,0,0
22:57:33,2,0,0,0,0,0
22:57:34,2,0,0,0,0,0
22:57:35,2,0,0,0,0,0
22:57:36,2,0,0,0,0,0
22:57:37,2,0,0,0,0,0
22:57:38,2,0,0,0,0,0
22:57:39,2,0,0,0,0,0
22:57:40,2,0,0,0,0,0
22:57:41,2,0,0,0,0,0
22:57:42,2,0,0,0,0,0
22:57:43,2,0,0,0,0,0
22:57:44,2,0,0,0,0,0
22:57:45,2,0,0,0,0,0
22:57:46,2,0,0,0,0,0
22:57:47,2,0,0,0,0,0
22:57:48,2,0,0,0,0,0
22:57:49,2,0,0,0,0,0
22:57:50,2,0,0,0,0,0
22:57:51,2,0,0,0,0,0
22:57:52,2,0,0,0,0,0
22:57:53,2,0,0,0,0,0
22:57:54,2,0,0,0,0,0
22:57:55,2,0,0,0,0,0
22:57:56,2,0,0,0,0,0
22:57:57,2,0,0,0,0,0
22:57:58,2,0,0,0,0,0
22:57:59,2,0,0,0,0,0
22:58:00,2,0,0,0,0,0
22:58:01,2,0,0,0,0,0
22:58:02,2,0,0,0,0,0
22:58:03,2,0,0,0,0,0
22:58:04,2,0,0,0,0,0
22:58:05,2,0,0,0,0,0
22:58:06,2,0,0,0,0,0
22:58:07,2,0,0,0,0,0
22:58:08,2,0,0,0,0,0
22:58:09,2,0,0,0,0,0
22:58:10,2,0,0,0,0,0
22:58:11,2,0,0,0,0,0
22:58:12,2,0,0,0,0,0
22:58:13,2,0,0,0,0,0
22:58:14,2,0,0,0,0,0
22:58:15,2,0,0,0,0,0
22:58:16,2,0,0,0,0,0
22:58:17,2,0,0,0,0,0
22:58:18,2,0,0,0,0,0
22:58:19,2,0,0,0,0,0
22:58:20,2,0,0,0,0,0
22:58:21,2,0,0,0,0,0
22:58:22,2,0,0,0,0,0
22:58:23,2,0,0,0,0,0
22:58:24,2,0,0,0,0,0
22:58:25,2,0,0,0,0,0
22:58:26,2,0,0,0,0,0
22:58:27,2,0,0,0,0,0
22:58:28,2,0,0,0,0,0
22:58:29,2,0,0,0,0,0
22:58:30,2,0,0,0,0,0
22:58:31,2,0,0,0,0,0
22:58:32,2,0,0,0,0,0
22:58:33,2,0,0,0,0,0
22:58:34,2,0,0,0,0,0
22:58:35,2,0,0,0,0,0
22:58:36,2,0,0,0,0,0
22:58:37,2,0,0,0,0,0
22:58:38,2,0,0,0,0,0
22:58:39,2,0,0,0,0,0
22:58:40,2,0,0,0,0,0
22:58:41,2,0,0,0,0,0
22:58:42,2,0,0,0,0,0
22:58:43,2,0,0,0,0,0
22:58:44,2,0,0,0,0,0
22:58:45,2,0,0,0,0,0
22:58:46,2,0,0,0,0,0
22:58:47,2,0,0,0,0,0
22:58:48,2,0,0,0,0,0
22:58:49,2,0,0,0,0,0
22:58:50,2,0,0,0,0,0
22:58:51,2,0,0,0,0,0
22:58:52,2,0,0,0,0,0
22:58:53,2,0,0,0,0,0
22:58:54,2,0,0,0,0,0
22:58:55,2,0,0,0,0,0
22:58:56,2,0,0,0,0,0
22:58:57,2,0,0,0,0,0
22:58:58,2,0,0,0,0,0
22:58:59,2,0,0,0,0,0
22:59:00,2,0,0,0,0,0
22:59:01,2,0,0,0,0,0
22:59:02,2,0,0,0,0,0
22:59:03,2,0,0,0,0,0
22:59:04,2,0,0,0,0,0
22:59:05,2,0,0,0,0,0
22:59:06,2,0,0,0,0,0
22:59:07,2,0,0,0,0,0
22:59:08,2,0,0,0,0,0
22:59:09,2,0,0,0,0,0
22:59:10,2,0,0,0,0,0
22:59:11,2,0,0,0,0,0
22:59:12,2,0,0,0,0,0
22:59:13,2,0,0,0,0,0
22:59:14,2,0,0,0,0,0
22:59:15,2,0,0,0,0,0
22:59:16,2,0,0,0,0,0
22:59:17,2,0,0,0,0,0
22:59:18,2,0,0,0,0,0
22:59:19,2,0,0,0,0,0
22:59:20,2,0,0,0,0,0
22:59:21,2,0,0,0,0,0
22:59:22,2,0,0,0,0,0
22:59:23,2,0,0,0,0,0
22:59:24,2,0,0,0,0,0
22:59:25,2,0,0,0,0,0
22:59:26,2,0,0,0,0,0
22:59:27,2,0,0,0,0,0
22:59:28,2,0,0,0,0,0
22:59:29,2,0,0,0,0,0
22:59:30,2,0,0,0,0,0
22:59:31,2,0,0,0,0,0
22:59:32,2,0,0,0,0,0
22:59:33,2,0,0,0,0,0
22:59:34,2,0,0,0,0,0
22:59:35,2,0,0,0,0,0
22:59:36,2,0,0,0,0,0
22:59:37,2,0,0,0,0,0
22:59:38,2,0,0,0,0,0
22:59:39,2,0,0,0,0,0
22:59:40,2,0,0,0,0,0
22:59:41,2,0,0,0,0,0
22:59:42,2,0,0,0,0,0
22:59:43,2,0,0,0,0,0
22:59:44,2,0,0,0,0,0
22:59:45,2,0,0,0,0,0
22:59:46,2,0,0,0,0,0
22:59:47,2,0,0,0,0,0
22:59:48,2,0,0,0,0,0
22:59:49,2,0,0,0,0,0
22:59:50,2,0,0,0,0,0
22:59:51,2,0,0,0,0,0
22:59:52,2,0,0,0,0,0
22:59:53,2,0,0,0,0,0
22:59:54,2,0,0,0,0,0
22:59:55,2,0,0,0,0,0
22:59:56,2,0,0,0,0,0
22:59:57,2,0,0,0,0,0
22:59:58,2,0,0,0,0,0
22:59:59,2,0,0,0,0,0
23:00:00,2,0,0,0,0,0
23:00:01,2,0,0,0,0,0
23:00:02,2,0,0,0,0,0
23:00:03,2,0,0,0,0,0
23:00:04,2,0,0,0,0,0
23:00:05,2,0,0,0,0,0
23:00:06,2,0,0,0,0,0
23:00:07,2,0,0,0,0,0
23:00:08,2,0,0,0,0,0
23:00:09,2,0,0,0,0,0
23:00:10,2,0,0,0,0,0
23:00:11,2,0,0,0,0,0
23:00:12,2,0,0,0,0,0
23:00:13,2,0,0,0,0,0
23:00:14,2,0,0,0,0,0
23:00:15,2,0,0,0,0,0
23:00:16,2,0,0,0,0,0
23:00:17,2,0,0,0,0,0
23:00:18,2,0,0,0,0,0
23:00:19,2,0,0,0,0,0
23:00:20,2,0,0,0,0,0
23:00:21,2,0,0,0,0,0
23:00:22,2,0,0,0,0,0
23:00:23,2,0,0,0,0,0
23:00:24,2,0,0,0,0,0
23:00:25,2,0,0,0,0,0
23:00:26,2,0,0,0,0,0
23:00:27,2,0,0,0,0,0
23:00:28,2,0,0,0,0,0
23:00:29,2,0,0,0,0,0
23:00:30,2,0,0,0,0,0
23:00:31,2,0,0,0,0,0
23:00:32,2,0,0,0,0,0
23:00:33,2,0,0,0,0,0
23:00:34,2,0,0,0,0,0
23:00:35,2,0,0,0,0,0
23:00:36,2,0,0,0,0,0
23:00:37,2,0,0,0,0,0
23:00:38,2,0,0,0,0,0
23:00:39,2,0,0,0,0,0
23:00:40,2,0,0,0,0,0
23:00:41,2,0,0,0,0,0
23:00:42,2,0,0,0,0,0
23:00:43,2,0,0,0,0,0
23:00:44,2,0,0,0,0,0
23:00:45,2,0,0,0,0,0
23:00:46,2,0,0,0,0,0
23:00:47,2,0,0,0,0,0
23:00:48,2,0,0,0,0,0
23:00:49,2,0,0,0,0,0
23:00:50,2,0,0,0,0,0
23:00:51,2,0,0,0,0,0
23:00:52,2,0,0,0,0,0
23:00:53,2,0,0,0,0,0
23:00:54,2,0,0,0,0,0
23:00:55,2,0,0,0,0,0
23:00:56,2,0,0,0,0,0
23:00:57,2,0,0,0,0,0
23:00:58,2,0,0,0,0,0
23:00:59,2,0,0,0,0,0
23:01:00,2,0,0,0,0,0
23:01:01,2,0,0,0,0,0
23:01:02,2,0,0,0,0,0
23:01:03,2,0,0,0,0,0
23:01:04,2,0,0,0,0,0
23:01:05,2,0,0,0,0,0
23:01:06,2,0,0,0,0,0
23:01:07,2,0,0,0,0,0
23:01:08,2,0,0,0,0,0
23:01:09,2,0,0,0,0,0
23:01:10,2,0,0,0,0,0
23:01:11,2,0,0,0,0,0
23:01:12,2,0,0,0,0,0
23:01:13,2,0,0,0,0,0
23:01:14,2,0,0,0,0,0
23:01:15,2,0,0,0,0,0
23:01:16,2,0,0,0,0,0
23:01:17,2,0,0,0,0,0
23:01:18,2,0,0,0,0,0
23:01:19,2,0,0,0,0,0
23:01:20,2,0,0,0,0,0
23:01:21,2,0,0,0,0,0
23:01:22,2,0,0,0,0,0
23:01:23,2,0,0,0,0,0
23:01:24,2,0,0,0,0,0
23:01:25,2,0,0,0,0,0
23:01:26,2,0,0,0,0,0
23:01:27,2,0,0,0,0,0
23:01:28,2,0,0,0,0,0
23:01:29,2,0,0,0,0,0
23:01:30,2,0,0,0,0,0
23:01:31,2,0,0,0,0,0
23:01:32,2,0,0,0,0,0
23:01:33,2,0,0,0,0,0
23:01:34,2,0,0,0,0,0
23:01:35,2,0,0,0,0,0
23:01:36,2,0,0,0,0,0
23:01:37,2,0,0,0,0,0
23:01:38,2,0,0,0,0,0
23:01:39,2,0,0,0,0,0
23:01:40,2,0,0,0,0,0
23:01:41,2,0,0,0,0,0
23:01:42,2,0,0,0,0,0
23:01:43,2,0,0,0,0,0
23:01:44,2,0,0,0,0,0
23:01:45,2,0,0,0,0,0
23:01:46,2,0,0,0,0,0
23:01:47,2,0,0,0,0,0
23:01:48,2,0,0,0,0,0
23:01:49,2,0,0,0,0,0
23:01:50,2,0,0,0,0,0
23:01:51,2,0,0,0,0,0
23:01:52,2,0,0,0,0,0
23:01:53,2,0,0,0,0,0
23:01:54,2,0,0,0,0,0
23:01:55,2,0,0,0,0,0
23:01:56,2,0,0,0,0,0
23:01:57,2,0,0,0,0,0
23:01:58,2,0,0,0,0,0
23:01:59,2,0,0,0,0,0
23:02:00,2,0,0,0,0,0
23:02:01,2,0,0,0,0,0
23:02:02,2,0,0,0,0,0
23:02:03,2,0,0,0,0,0
23:02:04,2,0,0,0,0,0
23:02:05,2,0,0,0,0,0
23:02:06,2,0,0,0,0,0
23:02:07,2,0,0,0,0,0
23:02:08,2,0,0,0,0,0
23:02:09,2,0,0,0,0,0
23:02:10,2,0,0,0,0,0
23:02:11,2,0,0,0,0,0
23:02:12,2,0,0,0,0,0
23:02:13,2,0,0,0,0,0
23:02:14,2,0,0,0,0,0
23:02:15,2,0,0,0,0,0
23:02:16,2,0,0,0,0,0
23:02:17,2,0,0,0,0,0
23:02:18,2,0,0,0,0,0
23:02:19,2,0,0,0,0,0
23:02:20,2,0,0,0,0,0
23:02:21,2,0,0,0,0,0
23:02:22,2,0,0,0,0,0
23:02:23,2,0,0,0,0,0
23:02:24,2,0,0,0,0,0
23:02:25,2,0,0,0,0,0
23:02:26,2,0,0,0,0,0
23:02:27,2,0,0,0,0,0
23:02:28,2,0,0,0,0,0
23:02:29,2,0,0,0,0,0
23:02:30,2,0,0,0,0,0
23:02:31,2,0,0,0,0,0
23:02:32,2,0,0,0,0,0
23:02:33,2,0,0,0,0,0
23:02:34,2,0,0,0,0,0
23:02:35,2,0,0,0,0,0
23:02:36,2,0,0,0,0,0
23:02:37,2,0,0,0,0,0
23:02:38,2,0,0,0,0,0
23:02:39,2,0,0,0,0,0
23:02:40,2,0,0,0,0,0
23:02:41,2,0,0,0,0,0
23:02:42,2,0,0,0,0,0
23:02:43,2,0,0,0,0,0
23:02:44,2,0,0,0,0,0
23:02:45,2,0,0,0,0,0
23:02:46,2,0,0,0,0,0
23:02:47,2,0,0,0,0,0
23:02:48,2,0,0,0,0,0
23:02:49,2,0,0,0,0,0
23:02:50,2,0,0,0,0,0
23:02:51,2,0,0,0,0,0
23:02:52,2,0,0,0,0,0
23:02:53,2,0,0,0,0,0
23:02:54,2,0,0,0,0,0
23:02:55,2,0,0,0,0,0
23:02:56,2,0,0,0,0,0
23:02:57,2,0,0,0,0,0
23:02:58,2,0,0,0,0,0
23:02:59,2,0,0,0,0,0
23:03:00,2,0,0,0,0,0
23:03:01,2,0,0,0,0,0
23:03:02,2,0,0,0,0,0
23:03:03,2,0,0,0,0,0
23:03:04,2,0,0,0,0,0
23:03:05,2,0,0,0,0,0
23:03:06,2,0,0,0,0,0
23:03:07,2,0,0,0,0,0
23:03:08,2,0,0,0,0,0
23:03:09,2,0,0,0,0,0
23:03:10,2,0,0,0,0,0
23:03:11,2,0,0,0,0,0
23:03:12,2,0,0,0,0,0
23:03:13,2,0,0,0,0,0
23:03:14,2,0,0,0,0,0
23:03:15,2,0,0,0,0,0
23:03:16,2,0,0,0,0,0
23:03:17,2,0,0,0,0,0
23:03:18,2,0,0,0,0,0
23:03:19,2,0,0,0,0,0
23:03:20,2,0,0,0,0,0
23:03:21,2,0,0,0,0,0
23:03:22,2,0,0,0,0,0
23:03:23,2,0,0,0,0,0
23:03:24,2,0,0,0,0,0
23:03:25,2,0,0,0,0,0
23:03:26,2,0,0,0,0,0
23:03:27,2,0,0,0,0,0
23:03:28,2,0,0,0,0,0
23:03:29,2,0,0,0,0,0
23:03:30,2,0,0,0,0,0
23:03:31,2,0,0,0,0,0
23:03:32,2,0,0,0,0,0
23:03:33,2,0,0,0,0,0
23:03:34,2,0,0,0,0,0
23:03:35,2,0,0,0,0,0
23:03:36,2,0,0,0,0,0
23:03:37,2,0,0,0,0,0
23:03:38,2,0,0,0,0,0
23:03:39,2,0,0,0,0,0
23:03:40,2,0,0,0,0,0
23:03:41,2,0,0,0,0,0
23:03:42,2,0,0,0,0,0
23:03:43,2,0,0,0,0,0
23:03:44,2,0,0,0,0,0
23:03:45,2,0,0,0,0,0
23:03:46,2,0,0,0,0,0
23:03:47,2,0,0,0,0,0
23:03:48,2,0,0,0,0,0
23:03:49,2,0,0,0,0,0
23:03:50,2,0,0,0,0,0
23:03:51,2,0,0,0,0,0
23:03:52,2,0,0,0,0,0
23:03:53,2,0,0,0,0,0
23:03:54,2,0,0,0,0,0
23:03:55,2,0,0,0,0,0
23:03:56,2,0,0,0,0,0
23:03:57,2,0,0,0,0,0
23:03:58,2,0,0,0,0,0
23:03:59,2,0,0,0,0,0
23:04:00,2,0,0,0,0,0
23:04:01,2,0,0,0,0,0
23:04:02,2,0,0,0,0,0
23:04:03,2,0,0,0,0,0
23:04:04,2,0,0,0,0,0
23:04:05,2,0,0,0,0,0
23:04:06,2,0,0,0,0,0
23:04:07,2,0,0,0,0,0
23:04:08,2,0,0,0,0,0
23:04:09,2,0,0,0,0,0
23:04:10,2,0,0,0,0,0
23:04:11,2,0,0,0,0,0
23:04:12,2,0,0,0,0,0
23:04:13,2,0,0,0,0,0
23:04:14,2,0,0,0,0,0
23:04:15,2,0,0,0,0,0
23:04:16,2,0,0,0,0,0
23:04:17,2,0,0,0,0,0
23:04:18,2,0,0,0,0,0
23:04:19,2,0,0,0,0,0
23:04:20,2,0,0,0,0,0
23:04:21,2,0,0,0,0,0
23:04:22,2,0,0,0,0,0
23:04:23,2,0,0,0,0,0
23:04:24,2,0,0,0,0,0
23:04:25,2,0,0,0,0,0
23:04:26,2,0,0,0,0,0
23:04:27,2,0,0,0,0,0
23:04:28,2,0,0,0,0,0
23:04:29,2,0,0,0,0,0
23:04:30,2,0,0,0,0,0
23:04:31,2,0,0,0,0,0
23:04:32,2,0,0,0,0,0
23:04:33,2,0,0,0,0,0
23:04:34,2,0,0,0,0,0
23:04:35,2,0,0,0,0,0
23:04:36,2,0,0,0,0,0
23:04:37,2,0,0,0,0,0
23:04:38,2,0,0,0,0,0
23:04:39,2,0,0,0,0,0
23:04:40,2,0,0,0,0,0
23:04:41,2,0,0,0,0,0
23:04:42,2,0,0,0,0,0
23:04:43,2,0,0,0,0,0
23:04:44,2,0,0,0,0,0
23:04:45,2,0,0,0,0,0
23:04:46,2,0,0,0,0,0
23:04:47,2,0,0,0,0,0
23:04:48,2,0,0,0,0,0
23:04:49,2,0,0,0,0,0
23:04:50,2,0,0,0,0,0
23:04:51,2,0,0,0,0,0
23:04:52,2,0,0,0,0,0
23:04:53,2,0,0,0,0,0
23:04:54,2,0,0,0,0,0
23:04:55,2,0,0,0,0,0
23:04:56,2,0,0,0,0,0
23:04:57,2,0,0,0,0,0
23:04:58,2,0,0,0,0,0
23:04:59,2,0,0,0,0,0
23:05:00,2,0,0,0,0,0
23:05:01,2,0,0,0,0,0
23:05:02,2,0,0,0,0,0
23:05:03,2,0,0,0,0,0
23:05:04,2,0,0,0,0,0
23:05:05,2,0,0,0,0,0
23:05:06,2,0,0,0,0,0
23:05:07,2,0,0,0,0,0
23:05:08,2,0,0,0,0,0
23:05:09,2,0,0,0,0,0
23:05:10,2,0,0,0,0,0
23:05:11,2,0,0,0,0,0
23:05:12,2,0,0,0,0,0
23:05:13,2,0,0,0,0,0
23:05:14,2,0,0,0,0,0
23:05:15,2,0,0,0,0,0
23:05:16,2,0,0,0,0,0
23:05:17,2,0,0,0,0,0
23:05:18,2,0,0,0,0,0
23:05:19,2,0,0,0,0,0
23:05:20,2,0,0,0,0,0
23:05:21,2,0,0,0,0,0
23:05:22,2,0,0,0,0,0
23:05:23,2,0,0,0,0,0
23:05:24,2,0,0,0,0,0
23:05:25,2,0,0,0,0,0
23:05:26,2,0,0,0,0,0
23:05:27,2,0,0,0,0,0
23:05:28,2,0,0,0,0,0
23:05:29,2,0,0,0,0,0
23:05:30,2,0,0,0,0,0
23:05:31,2,0,0,0,0,0
23:05:32,2,0,0,0,0,0
23:05:33,2,0,0,0,0,0
23:05:34,2,0,0,0,0,0
23:05:35,2,0,0,0,0,0
23:05:36,2,0,0,0,0,0
23:05:37,2,0,0,0,0,0
23:05:38,2,0,0,0,0,0
23:05:39,2,0,0,0,0,0
23:05:40,2,0,0,0,0,0
23:05:41,2,0,0,0,0,0
23:05:42,2,0,0,0,0,0
23:05:43,2,0,0,0,0,0
23:05:44,2,0,0,0,0,0
23:05:45,2,0,0,0,0,0
23:05:46,2,0,0,0,0,0
23:05:47,2,0,0,0,0,0
23:05:48,2,0,0,0,0,0
23:05:49,2,0,0,0,0,0
23:05:50,2,0,0,0,0,0
23:05:51,2,0,0,0,0,0
23:05:52,2,0,0,0,0,0
23:05:53,2,0,0,0,0,0
23:05:54,2,0,0,0,0,0
23:05:55,2,0,0,0,0,0
23:05:56,2,0,0,0,0,0
23:05:57,2,0,0,0,0,0
23:05:58,2,0,0,0,0,0
23:05:59,2,0,0,0,0,0
23:06:00,2,0,0,0,0,0
23:06:01,2,0,0,0,0,0
23:06:02,2,0,0,0,0,0
23:06:03,2,0,0,0,0,0
23:06:04,2,0,0,0,0,0
23:06:05,2,0,0,0,0,0
23:06:06,2,0,0,0,0,0
23:06:07,2,0,0,0,0,0
23:06:08,2,0,0,0,0,0
23:06:09,2,0,0,0,0,0
23:06:10,2,0,0,0,0,0
23:06:11,2,0,0,0,0,0
23:06:12,2,0,0,0,0,0
23:06:13,2,0,0,0,0,0
23:06:14,2,0,0,0,0,0
23:06:15,2,0,0,0,0,0
23:06:16,2,0,0,0,0,0
23:06:17,2,0,0,0,0,0
23:06:18,2,0,0,0,0,0
23:06:19,2,0,0,0,0,0
23:06:20,2,0,0,0,0,0
23:06:21,2,0,0,0,0,0
23:06:22,2,0,0,0,0,0
23:06:23,2,0,0,0,0,0
23:06:24,2,0,0,0,0,0
23:06:25,2,0,0,0,0,0
23:06:26,2,0,0,0,0,0
23:06:27,2,0,0,0,0,0
23:06:28,2,0,0,0,0,0
23:06:29,2,0,0,0,0,0
23:06:30,2,0,0,0,0,0
23:06:31,2,0,0,0,0,0
23:06:32,2,0,0,0,0,0
23:06:33,2,0,0,0,0,0
23:06:34,2,0,0,0,0,0
23:06:35,2,0,0,0,0,0
23:06:36,2,0,0,0,0,0
23:06:37,2,0,0,0,0,0
23:06:38,2,0,0,0,0,0
23:06:39,2,0,0,0,0,0
23:06:40,2,0,0,0,0,0
23:06:41,2,0,0,0,0,0
23:06:42,2,0,0,0,0,0
23:06:43,2,0,0,0,0,0
23:06:44,2,0,0,0,0,0
23:06:45,2,0,0,0,0,0
23:06:46,2,0,0,0,0,0
23:06:47,2,0,0,0,0,0
23:06:48,2,0,0,0,0,0
23:06:49,2,0,0,0,0,0
23:06:50,2,0,0,0,0,0
23:06:51,2,0,0,0,0,0
23:06:52,2,0,0,0,0,0
23:06:53,2,0,0,0,0,0
23:06:54,2,0,0,0,0,0
23:06:55,2,0,0,0,0,0
23:06:56,2,0,0,0,0,0
23:06:57,2,0,0,0,0,0
23:06:58,2,0,0,0,0,0
23:06:59,2,0,0,0,0,0
23:07:00,2,0,0,0,0,0
23:07:01,2,0,0,0,0,0
23:07:02,2,0,0,0,0,0
23:07:03,2,0,0,0,0,0
23:07:04,2,0,0,0,0,0
23:07:05,2,1005,492,534,0,2031
22:50:41,3,0,0,0,0,0
22:50:42,3,0,0,0,0,0
22:50:43,3,0,0,0,0,0
22:50:44,3,0,0,0,0,0
22:50:45,3,0,0,0,0,0
22:50:46,3,0,0,0,0,0
22:50:47,3,0,0,0,0,0
22:50:48,3,998,499,526,0,2023
22:50:49,3,999,504,526,0,2029
22:50:50,3,998,520,526,0,2044
22:50:51,3,0,0,0,0,0
22:50:52,3,998,487,526,0,2011
22:50:53,3,0,0,0,0,0
22:50:54,3,0,0,0,0,0
22:50:55,3,0,0,0,0,0
22:50:56,3,0,0,0,0,0
22:50:57,3,998,498,526,0,2022
22:50:58,3,0,0,0,0,0
22:50:59,3,999,497,526,0,2022
22:51:00,3,0,0,0,0,0
22:51:01,3,0,0,0,0,0
22:51:02,3,0,0,0,0,0
22:51:03,3,0,0,0,0,0
22:51:04,3,0,0,0,0,0
22:51:05,3,999,477,526,0,2002
22:51:06,3,0,0,0,0,0
22:51:07,3,0,0,0,0,0
22:51:08,3,0,0,0,0,0
22:51:09,3,0,0,0,0,0
22:51:10,3,0,0,0,0,0
22:51:11,3,997,505,525,0,2027
22:51:12,3,0,0,0,0,0
22:51:13,3,0,0,0,0,0
22:51:14,3,998,501,525,0,2024
22:51:15,3,0,0,0,0,0
22:51:16,3,0,0,0,0,0
22:51:17,3,0,0,0,0,0
22:51:18,3,0,0,0,0,0
22:51:19,3,0,0,0,0,0
22:51:20,3,0,0,0,0,0
22:51:21,3,998,491,525,0,2014
22:51:22,3,0,0,0,0,0
22:51:23,3,0,0,0,0,0
22:51:24,3,0,0,0,0,0
22:51:25,3,0,0,0,0,0
22:51:26,3,0,0,0,0,0
22:51:27,3,998,501,525,0,2024
22:51:28,3,0,0,0,0,0
22:51:29,3,0,0,0,0,0
22:51:30,3,0,0,0,0,0
22:51:31,3,0,0,0,0,0
22:51:32,3,0,0,0,0,0
22:51:33,3,0,0,0,0,0
22:51:34,3,0,0,0,0,0
22:51:35,3,0,0,0,0,0
22:51:36,3,998,880,525,0,2403
22:51:37,3,0,0,0,0,0
22:51:38,3,0,0,0,0,0
22:51:39,3,0,0,0,0,0
22:51:40,3,0,0,0,0,0
22:51:41,3,0,0,0,0,0
22:51:42,3,0,0,0,0,0
22:51:43,3,0,0,0,0,0
22:51:44,3,0,0,0,0,0
22:51:45,3,0,0,0,0,0
22:51:46,3,998,507,526,690,2721
22:51:47,3,0,0,0,0,0
22:51:48,3,0,0,0,0,0
22:51:49,3,0,0,0,0,0
22:51:50,3,998,501,526,518,2543
22:51:51,3,0,0,0,0,0
22:51:52,3,0,0,0,0,0
22:51:53,3,0,0,0,0,0
22:51:54,3,0,0,0,0,0
22:51:55,3,0,0,0,0,0
22:51:56,3,0,0,0,0,0
22:51:57,3,0,0,0,0,0
22:51:58,3,0,0,0,0,0
22:51:59,3,1004,551,585,648,2788
22:52:00,3,0,0,0,0,0
22:52:01,3,1003,494,596,730,2823
22:52:02,3,0,0,0,0,0
22:52:03,3,0,0,0,0,0
22:52:04,3,0,0,0,0,0
22:52:05,3,0,0,0,0,0
22:52:06,3,1001,492,641,442,2576
22:52:07,3,1001,492,641,378,2512
22:52:08,3,1001,489,643,664,2797
22:52:09,3,999,497,645,684,2825
22:52:10,3,0,0,0,0,0
22:52:11,3,999,522,646,565,2732
22:52:12,3,999,493,651,726,2869
22:52:13,3,1000,464,654,617,2735
22:52:14,3,1000,512,658,623,2793
22:52:15,3,0,0,0,0,0
22:52:16,3,0,0,0,0,0
22:52:17,3,0,0,0,0,0
22:52:18,3,0,0,0,0,0
22:52:19,3,0,0,0,0,0
22:52:20,3,999,501,672,567,2739
22:52:21,3,998,510,672,675,2855
22:52:22,3,0,0,0,0,0
22:52:23,3,998,482,677,494,2651
22:52:24,3,998,458,678,546,2680
22:52:25,3,998,502,679,589,2768
22:52:26,3,998,463,681,422,2564
22:52:27,3,998,474,682,558,2712
22:52:28,3,998,490,687,431,2606
22:52:29,3,0,0,0,0,0
22:52:30,3,998,498,700,492,2688
22:52:31,3,998,496,702,593,2789
22:52:32,3,997,488,702,482,2669
22:52:33,3,998,490,702,850,3040
22:52:34,3,0,0,0,0,0
22:52:35,3,997,478,701,825,3001
22:52:36,3,998,481,702,774,2955
22:52:37,3,998,503,703,867,3071
22:52:38,3,998,510,706,831,3045
22:52:39,3,998,509,702,850,3059
22:52:40,3,997,473,702,897,3069
22:52:41,3,997,503,702,848,3050
22:52:42,3,998,489,702,815,3004
22:52:43,3,998,500,702,859,3059
22:52:44,3,997,498,701,874,3070
22:52:45,3,997,508,701,837,3043
22:52:46,3,997,492,700,875,3064
22:52:47,3,997,493,700,839,3029
22:52:48,3,998,503,700,838,3039
22:52:49,3,998,507,700,961,3166
22:52:50,3,0,0,0,0,0
22:52:51,3,998,514,702,936,3150
22:52:52,3,0,0,0,0,0
22:52:53,3,997,491,705,854,3047
22:52:54,3,997,491,704,810,3002
22:52:55,3,997,488,704,906,3095
22:52:56,3,997,517,703,788,3005
22:52:57,3,997,497,702,850,3046
22:52:58,3,0,0,0,0,0
22:52:59,3,997,502,701,942,3142
22:53:00,3,997,457,701,953,3108
22:53:01,3,997,495,709,807,3008
22:53:02,3,0,0,0,0,0
22:53:03,3,998,508,707,871,3084
22:53:04,3,997,505,709,855,3066
22:53:05,3,998,448,710,883,3039
22:53:06,3,996,502,714,964,3176
22:53:07,3,996,471,712,876,3055
22:53:08,3,998,498,714,953,3163
22:53:09,3,997,487,716,913,3113
22:53:10,3,997,493,717,875,3082
22:53:11,3,999,511,720,842,3072
22:53:12,3,999,496,726,823,3044
22:53:13,3,999,505,728,877,3109
22:53:14,3,999,498,729,851,3077
22:53:15,3,998,488,731,846,3063
22:53:16,3,999,509,732,821,3061
22:53:17,3,999,525,733,762,3019
22:53:18,3,998,489,735,852,3074
22:53:19,3,997,483,735,769,2984
22:53:20,3,997,486,734,862,3079
22:53:21,3,998,500,734,850,3082
22:53:22,3,997,495,735,940,3167
22:53:23,3,998,492,735,796,3021
22:53:24,3,997,478,736,906,3117
22:53:25,3,997,645,736,860,3238
22:53:26,3,0,0,0,0,0
22:53:27,3,997,483,735,874,3089
22:53:28,3,0,0,0,0,0
22:53:29,3,996,486,736,855,3073
22:53:30,3,997,493,737,827,3054
22:53:31,3,997,500,736,878,3111
22:53:32,3,996,498,735,850,3079
22:53:33,3,0,0,0,0,0
22:53:34,3,996,486,734,908,3124
22:53:35,3,997,503,735,860,3095
22:53:36,3,999,499,737,858,3093
22:53:37,3,1001,488,738,877,3104
22:53:38,3,1000,484,741,892,3117
22:53:39,3,0,0,0,0,0
22:53:40,3,998,497,741,881,3117
22:53:41,3,997,503,740,934,3174
22:53:42,3,997,514,740,853,3104
22:53:43,3,998,497,741,950,3186
22:53:44,3,997,496,740,867,3100
22:53:45,3,997,499,739,822,3057
22:53:46,3,997,490,738,924,3149
22:53:47,3,997,491,736,907,3131
22:53:48,3,997,490,736,842,3065
22:53:49,3,997,500,735,871,3103
22:53:50,3,997,497,734,929,3157
22:53:51,3,0,0,0,0,0
22:53:52,3,997,484,731,902,3114
22:53:53,3,997,492,730,869,3088
22:53:54,3,997,487,729,862,3075
22:53:55,3,997,492,729,823,3041
22:53:56,3,997,486,729,864,3076
22:53:57,3,997,492,728,864,3081
22:53:58,3,997,490,727,895,3109
22:53:59,3,997,497,725,896,3115
22:54:00,3,997,491,724,887,3099
22:54:01,3,997,496,724,873,3090
22:54:02,3,997,481,723,889,3090
22:54:03,3,997,496,722,895,3110
22:54:04,3,997,490,721,866,3074
22:54:05,3,997,488,720,909,3114
22:54:06,3,997,488,720,829,3034
22:54:07,3,997,459,720,897,3073
22:54:08,3,998,486,718,816,3018
22:54:09,3,998,489,717,895,3099
22:54:10,3,997,476,716,814,3003
22:54:11,3,997,498,714,751,2960
22:54:12,3,998,349,714,844,2905
22:54:13,3,997,496,713,882,3088
22:54:14,3,998,504,714,973,3189
22:54:15,3,999,491,715,883,3088
22:54:16,3,999,492,717,943,3151
22:54:17,3,999,497,717,855,3068
22:54:18,3,998,501,719,807,3025
22:54:19,3,999,525,721,844,3089
22:54:20,3,999,501,724,825,3049
22:54:21,3,999,497,724,880,3100
22:54:22,3,997,483,726,823,3029
22:54:23,3,1000,483,727,817,3027
22:54:24,3,998,509,728,783,3018
22:54:25,3,999,511,729,849,3088
22:54:26,3,999,496,730,952,3177
22:54:27,3,998,497,728,861,3084
22:54:28,3,998,508,726,873,3105
22:54:29,3,998,497,725,827,3047
22:54:30,3,998,511,724,881,3114
22:54:31,3,998,497,724,756,2975
22:54:32,3,998,491,723,911,3123
22:54:33,3,997,503,721,886,3107
22:54:34,3,998,491,718,899,3106
22:54:35,3,997,492,717,975,3181
22:54:36,3,998,507,716,845,3066
22:54:37,3,997,494,715,874,3080
22:54:38,3,998,493,714,908,3113
22:54:39,3,997,484,714,879,3074
22:54:40,3,997,492,714,985,3188
22:54:41,3,997,478,713,902,3090
22:54:42,3,998,491,713,954,3156
22:54:43,3,998,498,713,836,3045
22:54:44,3,998,499,712,875,3084
22:54:45,3,997,493,712,876,3078
22:54:46,3,998,487,710,754,2949
22:54:47,3,997,496,709,817,3019
22:54:48,3,998,497,706,931,3132
22:54:49,3,998,483,707,829,3017
22:54:50,3,997,506,704,877,3084
22:54:51,3,998,496,702,846,3042
22:54:52,3,997,494,700,852,3043
22:54:53,3,998,484,698,868,3048
22:54:54,3,0,0,0,0,0
22:54:55,3,0,0,0,0,0
22:54:56,3,997,493,693,863,3046
22:54:57,3,997,509,691,789,2986
22:54:58,3,997,497,691,798,2983
22:54:59,3,997,489,691,836,3013
22:55:00,3,997,504,691,897,3089
22:55:01,3,997,497,691,892,3077
22:55:02,3,997,497,690,900,3084
22:55:03,3,998,498,690,835,3021
22:55:04,3,997,489,690,959,3135
22:55:05,3,997,503,690,994,3184
22:55:06,3,997,491,688,903,3079
22:55:07,3,997,485,688,935,3105
22:55:08,3,0,0,0,0,0
22:55:09,3,0,0,0,0,0
22:55:10,3,997,489,686,903,3075
22:55:11,3,998,496,687,852,3033
22:55:12,3,998,498,686,780,2962
22:55:13,3,997,488,686,893,3064
22:55:14,3,997,484,686,859,3026
22:55:15,3,997,491,686,880,3054
22:55:16,3,997,494,685,864,3040
22:55:17,3,997,495,685,860,3037
22:55:18,3,997,491,685,833,3006
22:55:19,3,997,497,684,867,3045
22:55:20,3,998,488,684,858,3028
22:55:21,3,1000,481,688,947,3116
22:55:22,3,999,499,690,773,2961
22:55:23,3,999,482,690,845,3016
22:55:24,3,999,497,693,809,2998
22:55:25,3,998,491,692,846,3027
22:55:26,3,998,493,692,849,3032
22:55:27,3,999,489,691,894,3073
22:55:28,3,998,513,691,926,3128
22:55:29,3,0,0,0,0,0
22:55:30,3,998,496,688,839,3021
22:55:31,3,997,478,688,931,3094
22:55:32,3,998,504,687,862,3051
22:55:33,3,0,0,0,0,0
22:55:34,3,998,499,686,928,3111
22:55:35,3,0,0,0,0,0
22:55:36,3,0,0,0,0,0
22:55:37,3,998,500,685,798,2981
22:55:38,3,998,487,685,909,3079
22:55:39,3,998,517,684,955,3154
22:55:40,3,998,501,685,861,3045
22:55:41,3,998,497,685,884,3064
22:55:42,3,998,497,682,927,3104
22:55:43,3,998,495,682,882,3057
22:55:44,3,998,497,681,826,3002
22:55:45,3,0,0,0,0,0
22:55:46,3,998,499,679,937,3113
22:55:47,3,0,0,0,0,0
22:55:48,3,998,501,678,929,3106
22:55:49,3,999,501,677,918,3095
22:55:50,3,998,501,677,795,2971
22:55:51,3,998,504,676,853,3031
22:55:52,3,998,505,675,959,3137
22:55:53,3,998,489,673,900,3060
22:55:54,3,0,0,0,0,0
22:55:55,3,998,499,671,934,3102
22:55:56,3,998,489,671,860,3018
22:55:57,3,998,491,671,761,2921
22:55:58,3,998,501,670,914,3083
22:55:59,3,998,503,670,962,3133
22:56:00,3,997,497,669,815,2978
22:56:01,3,998,495,669,830,2992
22:56:02,3,0,0,0,0,0
22:56:03,3,997,497,667,869,3030
22:56:04,3,998,496,667,928,3089
22:56:05,3,998,496,666,884,3044
22:56:06,3,998,505,665,994,3162
22:56:07,3,0,0,0,0,0
22:56:08,3,0,0,0,0,0
22:56:09,3,997,504,663,819,2983
22:56:10,3,0,0,0,0,0
22:56:11,3,0,0,0,0,0
22:56:12,3,0,0,0,0,0
22:56:13,3,997,490,659,899,3045
22:56:14,3,0,0,0,0,0
22:56:15,3,997,499,658,905,3059
22:56:16,3,997,497,657,882,3033
22:56:17,3,0,0,0,0,0
22:56:18,3,997,496,657,645,2795
22:56:19,3,996,490,657,414,2557
22:56:20,3,0,0,0,0,0
22:56:21,3,997,495,659,711,2862
22:56:22,3,997,487,660,665,2809
22:56:23,3,0,0,0,0,0
22:56:24,3,997,494,661,460,2612
22:56:25,3,0,0,0,0,0
22:56:26,3,0,0,0,0,0
22:56:27,3,0,0,0,0,0
22:56:28,3,997,505,664,553,2719
22:56:29,3,997,494,664,781,2936
22:56:30,3,998,495,665,475,2633
22:56:31,3,997,493,665,560,2715
22:56:32,3,997,506,666,364,2533
22:56:33,3,997,496,666,626,2785
22:56:34,3,997,491,665,647,2800
22:56:35,3,998,510,665,634,2807
22:56:36,3,998,493,665,517,2673
22:56:37,3,0,0,0,0,0
22:56:38,3,998,498,665,701,2862
22:56:39,3,998,503,665,513,2679
22:56:40,3,998,492,666,491,2647
22:56:41,3,997,494,666,539,2696
22:56:42,3,0,0,0,0,0
22:56:43,3,998,499,666,329,2492
22:56:44,3,997,493,666,405,2561
22:56:45,3,0,0,0,0,0
22:56:46,3,997,473,668,688,2826
22:56:47,3,997,495,668,547,2707
22:56:48,3,998,471,670,799,2938
22:56:49,3,998,477,671,361,2507
22:56:50,3,998,487,673,465,2623
22:56:51,3,997,499,673,654,2823
22:56:52,3,997,484,674,699,2854
22:56:53,3,998,490,674,433,2595
22:56:54,3,0,0,0,0,0
22:56:55,3,997,497,673,467,2634
22:56:56,3,997,495,673,553,2718
22:56:57,3,997,490,673,535,2695
22:56:58,3,997,510,672,518,2697
22:56:59,3,997,490,671,982,3140
22:57:00,3,997,498,672,814,2981
22:57:01,3,997,473,671,974,3115
22:57:02,3,997,489,670,927,3083
22:57:03,3,998,485,671,846,3000
22:57:04,3,0,0,0,0,0
22:57:05,3,0,0,0,0,0
22:57:06,3,0,0,0,0,0
22:57:07,3,0,0,0,0,0
22:57:08,3,998,486,667,971,3122
22:57:09,3,997,499,665,849,3010
22:57:10,3,998,505,665,909,3077
22:57:11,3,0,0,0,0,0
22:57:12,3,998,492,663,905,3058
22:57:13,3,998,493,663,896,3050
22:57:14,3,998,501,662,984,3145
22:57:15,3,0,0,0,0,0
22:57:16,3,997,507,661,887,3052
22:57:17,3,998,493,658,916,3065
22:57:18,3,0,0,0,0,0
22:57:19,3,998,493,657,934,3082
22:57:20,3,998,484,656,704,2842
22:57:21,3,0,0,0,0,0
22:57:22,3,998,488,654,393,2533
22:57:23,3,997,499,652,425,2573
22:57:24,3,998,487,652,561,2698
22:57:25,3,997,497,650,396,2540
22:57:26,3,0,0,0,0,0
22:57:27,3,997,485,648,530,2660
22:57:28,3,997,499,647,370,2513
22:57:29,3,0,0,0,0,0
22:57:30,3,997,498,646,443,2584
22:57:31,3,997,495,645,620,2757
22:57:32,3,997,496,645,648,2786
22:57:33,3,997,506,644,555,2702
22:57:34,3,997,490,645,402,2534
22:57:35,3,0,0,0,0,0
22:57:36,3,0,0,0,0,0
22:57:37,3,0,0,0,0,0
22:57:38,3,997,500,644,679,2820
22:57:39,3,998,492,647,718,2855
22:57:40,3,0,0,0,0,0
22:57:41,3,0,0,0,0,0
22:57:42,3,997,487,647,490,2621
22:57:43,3,996,520,666,505,2687
22:57:44,3,997,495,665,643,2800
22:57:45,3,0,0,0,0,0
22:57:46,3,0,0,0,0,0
22:57:47,3,997,499,662,369,2527
22:57:48,3,996,505,660,551,2712
22:57:49,3,997,489,658,540,2684
22:57:50,3,997,499,658,384,2538
22:57:51,3,997,497,657,496,2647
22:57:52,3,997,501,657,407,2562
22:57:53,3,0,0,0,0,0
22:57:54,3,997,491,654,696,2838
22:57:55,3,997,494,654,612,2757
22:57:56,3,998,486,652,630,2766
22:57:57,3,997,484,652,453,2586
22:57:58,3,997,500,650,524,2671
22:57:59,3,997,490,649,605,2741
22:58:00,3,997,529,648,701,2875
22:58:01,3,0,0,0,0,0
22:58:02,3,0,0,0,0,0
22:58:03,3,997,495,644,901,3037
22:58:04,3,997,512,643,898,3050
22:58:05,3,0,0,0,0,0
22:58:06,3,0,0,0,0,0
22:58:07,3,996,495,641,913,3045
22:58:08,3,997,494,640,878,3009
22:58:09,3,997,491,640,881,3009
22:58:10,3,0,0,0,0,0
22:58:11,3,0,0,0,0,0
22:58:12,3,0,0,0,0,0
22:58:13,3,0,0,0,0,0
22:58:14,3,0,0,0,0,0
22:58:15,3,0,0,0,0,0
22:58:16,3,0,0,0,0,0
22:58:17,3,0,0,0,0,0
22:58:18,3,0,0,0,0,0
22:58:19,3,0,0,0,0,0
22:58:20,3,996,493,633,950,3072
22:58:21,3,997,495,633,931,3056
22:58:22,3,997,490,633,855,2975
22:58:23,3,0,0,0,0,0
22:58:24,3,997,489,632,881,2999
22:58:25,3,0,0,0,0,0
22:58:26,3,997,507,630,881,3015
22:58:27,3,0,0,0,0,0
22:58:28,3,0,0,0,0,0
22:58:29,3,0,0,0,0,0
22:58:30,3,0,0,0,0,0
22:58:31,3,998,500,628,877,3003
22:58:32,3,0,0,0,0,0
22:58:33,3,0,0,0,0,0
22:58:34,3,0,0,0,0,0
22:58:35,3,0,0,0,0,0
22:58:36,3,0,0,0,0,0
22:58:37,3,0,0,0,0,0
22:58:38,3,0,0,0,0,0
22:58:39,3,998,506,624,258,2386
22:58:40,3,998,508,624,593,2723
22:58:41,3,997,495,623,648,2763
22:58:42,3,0,0,0,0,0
22:58:43,3,998,507,623,311,2439
22:58:44,3,998,495,622,285,2400
22:58:45,3,0,0,0,0,0
22:58:46,3,997,485,621,308,2411
22:58:47,3,0,0,0,0,0
22:58:48,3,0,0,0,0,0
22:58:49,3,0,0,0,0,0
22:58:50,3,0,0,0,0,0
22:58:51,3,998,496,618,466,2578
22:58:52,3,0,0,0,0,0
22:58:53,3,0,0,0,0,0
22:58:54,3,0,0,0,0,0
22:58:55,3,0,0,0,0,0
22:58:56,3,997,478,625,920,3020
22:58:57,3,0,0,0,0,0
22:58:58,3,0,0,0,0,0
22:58:59,3,998,450,636,948,3032
22:59:00,3,0,0,0,0,0
22:59:01,3,0,0,0,0,0
22:59:02,3,0,0,0,0,0
22:59:03,3,0,0,0,0,0
22:59:04,3,997,507,645,904,3053
22:59:05,3,0,0,0,0,0
22:59:06,3,997,477,644,918,3036
22:59:07,3,0,0,0,0,0
22:59:08,3,0,0,0,0,0
22:59:09,3,0,0,0,0,0
22:59:10,3,998,494,640,825,2957
22:59:11,3,0,0,0,0,0
22:59:12,3,0,0,0,0,0
22:59:13,3,0,0,0,0,0
22:59:14,3,0,0,0,0,0
22:59:15,3,0,0,0,0,0
22:59:16,3,0,0,0,0,0
22:59:17,3,997,506,635,888,3026
22:59:18,3,0,0,0,0,0
22:59:19,3,998,493,634,863,2988
22:59:20,3,0,0,0,0,0
22:59:21,3,0,0,0,0,0
22:59:22,3,0,0,0,0,0
22:59:23,3,0,0,0,0,0
22:59:24,3,0,0,0,0,0
22:59:25,3,0,0,0,0,0
22:59:26,3,997,490,630,971,3088
22:59:27,3,0,0,0,0,0
22:59:28,3,0,0,0,0,0
22:59:29,3,997,508,628,905,3038
22:59:30,3,0,0,0,0,0
22:59:31,3,997,391,625,886,2899
22:59:32,3,0,0,0,0,0
22:59:33,3,997,493,623,946,3059
22:59:34,3,996,490,623,809,2918
22:59:35,3,0,0,0,0,0
22:59:36,3,997,488,621,948,3054
22:59:37,3,996,498,620,859,2973
22:59:38,3,997,1005,619,909,3530
22:59:39,3,0,0,0,0,0
22:59:40,3,0,0,0,0,0
22:59:41,3,0,0,0,0,0
22:59:42,3,0,0,0,0,0
22:59:43,3,997,500,617,874,2988
22:59:44,3,997,492,615,898,3002
22:59:45,3,997,488,615,910,3010
22:59:46,3,0,0,0,0,0
22:59:47,3,998,601,614,890,3103
22:59:48,3,997,516,613,906,3032
22:59:49,3,0,0,0,0,0
22:59:50,3,998,487,611,918,3014
22:59:51,3,999,496,611,877,2983
22:59:52,3,999,506,610,805,2920
22:59:53,3,998,490,609,895,2992
22:59:54,3,998,497,609,963,3067
22:59:55,3,998,497,609,874,2978
22:59:56,3,999,489,608,910,3006
22:59:57,3,999,493,607,840,2939
22:59:58,3,999,488,607,938,3032
22:59:59,3,998,494,606,930,3028
23:00:00,3,998,493,607,941,3039
23:00:01,3,998,492,607,888,2985
23:00:02,3,998,479,607,928,3012
23:00:03,3,998,494,605,930,3027
23:00:04,3,998,496,605,882,2981
23:00:05,3,998,500,605,919,3022
23:00:06,3,998,500,604,949,3051
23:00:07,3,998,503,603,878,2982
23:00:08,3,999,477,602,844,2922
23:00:09,3,0,0,0,0,0
23:00:10,3,998,493,602,875,2968
23:00:11,3,999,467,601,917,2984
23:00:12,3,999,496,601,885,2981
23:00:13,3,999,480,602,866,2947
23:00:14,3,999,497,604,821,2921
23:00:15,3,999,488,604,927,3018
23:00:16,3,1000,495,603,906,3004
23:00:17,3,1000,492,602,926,3020
23:00:18,3,999,491,602,900,2992
23:00:19,3,999,480,602,915,2996
23:00:20,3,1000,496,602,870,2968
23:00:21,3,1000,469,602,874,2945
23:00:22,3,1000,459,602,928,2989
23:00:23,3,999,484,603,901,2987
23:00:24,3,999,490,604,916,3009
23:00:25,3,999,492,604,833,2928
23:00:26,3,999,496,604,886,2985
23:00:27,3,1000,494,604,996,3094
23:00:28,3,1000,495,604,952,3051
23:00:29,3,1000,490,604,933,3027
23:00:30,3,999,490,605,933,3027
23:00:31,3,1000,500,605,936,3041
23:00:32,3,1000,490,604,903,2997
23:00:33,3,1000,489,603,900,2992
23:00:34,3,1000,482,603,888,2973
23:00:35,3,1000,499,602,885,2986
23:00:36,3,998,490,601,936,3025
23:00:37,3,999,488,600,888,2975
23:00:38,3,998,497,600,874,2969
23:00:39,3,999,507,600,941,3047
23:00:40,3,999,501,600,938,3038
23:00:41,3,0,0,0,0,0
23:00:42,3,1001,494,600,958,3053
23:00:43,3,999,492,598,961,3050
23:00:44,3,999,491,598,956,3044
23:00:45,3,1001,485,598,976,3060
23:00:46,3,1000,504,598,933,3035
23:00:47,3,999,501,597,909,3006
23:00:48,3,998,489,596,933,3016
23:00:49,3,998,486,595,938,3017
23:00:50,3,998,491,595,975,3059
23:00:51,3,1000,492,593,925,3010
23:00:52,3,999,493,593,950,3035
23:00:53,3,0,0,0,0,0
23:00:54,3,998,487,592,980,3057
23:00:55,3,0,0,0,0,0
23:00:56,3,999,495,593,938,3025
23:00:57,3,999,493,594,912,2998
23:00:58,3,1000,500,594,164,2258
23:00:59,3,1000,503,594,119,2216
23:01:00,3,999,488,594,77,2158
23:01:01,3,1000,489,594,135,2218
23:01:02,3,1000,500,593,153,2246
23:01:03,3,1000,505,593,117,2215
23:01:04,3,999,491,592,178,2260
23:01:05,3,998,500,591,175,2264
23:01:06,3,999,482,591,126,2198
23:01:07,3,1001,521,591,193,2306
23:01:08,3,999,500,590,158,2247
23:01:09,3,999,512,590,171,2272
23:01:10,3,1000,480,590,132,2202
23:01:11,3,999,517,590,90,2196
23:01:12,3,999,480,590,158,2227
23:01:13,3,1000,489,589,155,2233
23:01:14,3,1001,496,589,120,2206
23:01:15,3,1000,513,591,149,2253
23:01:16,3,1001,473,590,54,2118
23:01:17,3,1000,486,589,133,2208
23:01:18,3,1000,480,587,148,2215
23:01:19,3,1000,496,586,2,2084
23:01:20,3,1000,501,585,2,2088
23:01:21,3,1000,511,585,2,2098
23:01:22,3,1000,506,585,4,2095
23:01:23,3,1000,494,583,3,2080
23:01:24,3,1000,507,583,0,2090
23:01:25,3,1000,500,583,2,2085
23:01:26,3,0,0,0,0,0
23:01:27,3,1000,491,582,2,2075
23:01:28,3,1001,484,582,2,2069
23:01:29,3,1000,492,581,2,2075
23:01:30,3,1000,513,581,2,2096
23:01:31,3,1000,507,580,2,2089
23:01:32,3,1000,491,580,3,2074
23:01:33,3,1001,471,580,1,2053
23:01:34,3,1001,510,579,2,2092
23:01:35,3,1002,493,579,2,2076
23:01:36,3,1001,476,579,3,2059
23:01:37,3,1002,492,579,3,2076
23:01:38,3,1001,492,578,2,2073
23:01:39,3,1001,503,577,2,2083
23:01:40,3,1001,469,577,2,2049
23:01:41,3,1001,521,577,2,2101
23:01:42,3,1001,470,576,2,2049
23:01:43,3,1000,500,576,2,2078
23:01:44,3,1000,445,575,3,2023
23:01:45,3,1002,507,575,2,2086
23:01:46,3,1000,517,575,2,2094
23:01:47,3,0,0,0,0,0
23:01:48,3,1002,485,575,0,2062
23:01:49,3,1001,469,575,2,2047
23:01:50,3,1002,486,575,5,2068
23:01:51,3,1002,502,574,2,2080
23:01:52,3,1001,494,574,2,2071
23:01:53,3,1002,461,574,2,2039
23:01:54,3,1001,479,574,1,2055
23:01:55,3,1001,524,573,0,2098
23:01:56,3,1000,499,573,1,2073
23:01:57,3,1001,510,573,0,2084
23:01:58,3,1001,478,573,0,2052
23:01:59,3,1000,495,572,1,2068
23:02:00,3,1001,490,572,1,2064
23:02:01,3,1002,498,572,1,2073
23:02:02,3,1001,479,572,0,2052
23:02:03,3,1001,520,572,1,2094
23:02:04,3,1002,435,572,0,2009
23:02:05,3,0,0,0,0,0
23:02:06,3,0,0,0,0,0
23:02:07,3,0,0,0,0,0
23:02:08,3,1002,497,571,1,2071
23:02:09,3,0,0,0,0,0
23:02:10,3,1002,473,570,0,2045
23:02:11,3,1000,490,570,0,2060
23:02:12,3,1001,479,570,1,2051
23:02:13,3,0,0,0,0,0
23:02:14,3,0,0,0,0,0
23:02:15,3,1000,490,569,0,2059
23:02:16,3,1000,498,568,1,2067
23:02:17,3,0,0,0,0,0
23:02:18,3,999,509,567,1,2076
23:02:19,3,0,0,0,0,0
23:02:20,3,1000,499,566,0,2065
23:02:21,3,999,493,565,1,2058
23:02:22,3,0,0,0,0,0
23:02:23,3,0,0,0,0,0
23:02:24,3,1000,493,564,1,2058
23:02:25,3,1000,492,563,0,2055
23:02:26,3,999,510,563,2,2074
23:02:27,3,999,490,563,1,2053
23:02:28,3,999,494,562,0,2055
23:02:29,3,999,493,561,1,2054
23:02:30,3,999,498,561,1,2059
23:02:31,3,999,490,561,1,2051
23:02:32,3,999,499,561,2,2061
23:02:33,3,999,481,561,1,2042
23:02:34,3,999,496,560,0,2055
23:02:35,3,999,505,560,1,2065
23:02:36,3,998,496,559,1,2054
23:02:37,3,0,0,0,0,0
23:02:38,3,998,483,559,0,2040
23:02:39,3,999,493,559,0,2051
23:02:40,3,998,499,558,1,2056
23:02:41,3,999,504,558,1,2062
23:02:42,3,999,514,558,0,2071
23:02:43,3,999,505,558,1,2063
23:02:44,3,998,498,557,0,2053
23:02:45,3,998,494,557,1,2050
23:02:46,3,998,505,557,0,2060
23:02:47,3,998,507,557,1,2063
23:02:48,3,0,0,0,0,0
23:02:49,3,998,491,556,0,2045
23:02:50,3,0,0,0,0,0
23:02:51,3,0,0,0,0,0
23:02:52,3,997,482,555,1,2035
23:02:53,3,997,495,555,0,2047
23:02:54,3,997,493,555,0,2045
23:02:55,3,996,296,555,0,1847
23:02:56,3,994,487,555,0,2036
23:02:57,3,995,490,554,0,2039
23:02:58,3,994,489,554,0,2037
23:02:59,3,994,482,554,0,2030
23:03:00,3,994,506,554,0,2054
23:03:01,3,994,491,554,0,2039
23:03:02,3,994,483,554,1,2032
23:03:03,3,996,488,554,0,2038
23:03:04,3,997,498,553,0,2048
23:03:05,3,998,508,554,2,2062
23:03:06,3,0,0,0,0,0
23:03:07,3,0,0,0,0,0
23:03:08,3,997,493,552,1,2043
23:03:09,3,0,0,0,0,0
23:03:10,3,997,492,551,1,2041
23:03:11,3,0,0,0,0,0
23:03:12,3,0,0,0,0,0
23:03:13,3,998,504,551,0,2053
23:03:14,3,0,0,0,0,0
23:03:15,3,0,0,0,0,0
23:03:16,3,0,0,0,0,0
23:03:17,3,0,0,0,0,0
23:03:18,3,0,0,0,0,0
23:03:19,3,0,0,0,0,0
23:03:20,3,995,484,549,0,2028
23:03:21,3,0,0,0,0,0
23:03:22,3,0,0,0,0,0
23:03:23,3,995,499,549,1,2044
23:03:24,3,997,489,549,1,2036
23:03:25,3,997,497,549,0,2043
23:03:26,3,0,0,0,0,0
23:03:27,3,998,488,549,2,2037
23:03:28,3,0,0,0,0,0
23:03:29,3,0,0,0,0,0
23:03:30,3,998,488,548,0,2034
23:03:31,3,998,498,548,2,2046
23:03:32,3,998,490,548,1,2037
23:03:33,3,0,0,0,0,0
23:03:34,3,0,0,0,0,0
23:03:35,3,998,493,548,0,2039
23:03:36,3,997,490,548,2,2037
23:03:37,3,0,0,0,0,0
23:03:38,3,998,487,547,1,2033
23:03:39,3,0,0,0,0,0
23:03:40,3,998,489,547,0,2034
23:03:41,3,998,483,547,1,2029
23:03:42,3,998,494,547,1,2040
23:03:43,3,0,0,0,0,0
23:03:44,3,997,498,546,0,2041
23:03:45,3,996,490,547,2,2035
23:03:46,3,0,0,0,0,0
23:03:47,3,0,0,0,0,0
23:03:48,3,996,501,546,1,2044
23:03:49,3,996,487,546,1,2030
23:03:50,3,995,501,547,1,2044
23:03:51,3,996,498,547,2,2043
23:03:52,3,0,0,0,0,0
23:03:53,3,0,0,0,0,0
23:03:54,3,993,498,546,0,2037
23:03:55,3,993,492,546,0,2031
23:03:56,3,993,487,547,0,2027
23:03:57,3,993,497,547,1,2038
23:03:58,3,0,0,0,0,0
23:03:59,3,0,0,0,0,0
23:04:00,3,0,0,0,0,0
23:04:01,3,999,495,547,1,2042
23:04:02,3,999,499,547,1,2046
23:04:03,3,999,488,546,1,2034
23:04:04,3,999,498,546,0,2043
23:04:05,3,999,494,546,0,2039
23:04:06,3,999,492,546,0,2037
23:04:07,3,999,496,546,0,2041
23:04:08,3,999,493,546,1,2039
23:04:09,3,998,494,546,0,2038
23:04:10,3,998,502,546,1,2047
23:04:11,3,0,0,0,0,0
23:04:12,3,999,495,545,1,2040
23:04:13,3,0,0,0,0,0
23:04:14,3,999,496,545,1,2041
23:04:15,3,999,500,545,0,2044
23:04:16,3,999,514,545,1,2059
23:04:17,3,0,0,0,0,0
23:04:18,3,0,0,0,0,0
23:04:19,3,0,0,0,0,0
23:04:20,3,999,510,544,0,2053
23:04:21,3,999,490,544,0,2033
23:04:22,3,999,505,544,2,2050
23:04:23,3,999,499,544,1,2043
23:04:24,3,0,0,0,0,0
23:04:25,3,999,510,544,0,2053
23:04:26,3,0,0,0,0,0
23:04:27,3,0,0,0,0,0
23:04:28,3,0,0,0,0,0
23:04:29,3,999,499,544,0,2042
23:04:30,3,0,0,0,0,0
23:04:31,3,999,500,544,0,2043
23:04:32,3,998,501,544,0,2043
23:04:33,3,0,0,0,0,0
23:04:34,3,998,506,544,1,2049
23:04:35,3,0,0,0,0,0
23:04:36,3,998,485,543,1,2027
23:04:37,3,0,0,0,0,0
23:04:38,3,998,495,543,0,2036
23:04:39,3,998,500,544,1,2043
23:04:40,3,0,0,0,0,0
23:04:41,3,0,0,0,0,0
23:04:42,3,998,494,543,1,2036
23:04:43,3,998,493,543,0,2034
23:04:44,3,0,0,0,0,0
23:04:45,3,0,0,0,0,0
23:04:46,3,998,504,542,0,2044
23:04:47,3,0,0,0,0,0
23:04:48,3,0,0,0,0,0
23:04:49,3,997,496,542,0,2035
23:04:50,3,0,0,0,0,0
23:04:51,3,0,0,0,0,0
23:04:52,3,0,0,0,0,0
23:04:53,3,0,0,0,0,0
23:04:54,3,998,493,541,0,2032
23:04:55,3,998,512,541,0,2051
23:04:56,3,0,0,0,0,0
23:04:57,3,999,499,542,0,2040
23:04:58,3,0,0,0,0,0
23:04:59,3,998,495,542,1,2036
23:05:00,3,998,496,541,1,2036
23:05:01,3,0,0,0,0,0
23:05:02,3,0,0,0,0,0
23:05:03,3,998,494,541,0,2033
23:05:04,3,0,0,0,0,0
23:05:05,3,0,0,0,0,0
23:05:06,3,999,506,541,0,2046
23:05:07,3,998,499,541,1,2039
23:05:08,3,998,504,542,0,2044
23:05:09,3,0,0,0,0,0
23:05:10,3,998,499,541,0,2038
23:05:11,3,998,489,541,0,2028
23:05:12,3,0,0,0,0,0
23:05:13,3,998,483,541,1,2023
23:05:14,3,0,0,0,0,0
23:05:15,3,0,0,0,0,0
23:05:16,3,998,493,541,1,2033
23:05:17,3,998,507,541,2,2048
23:05:18,3,0,0,0,0,0
23:05:19,3,0,0,0,0,0
23:05:20,3,998,502,541,1,2042
23:05:21,3,998,494,541,0,2033
23:05:22,3,998,499,541,2,2040
23:05:23,3,998,498,541,1,2038
23:05:24,3,0,0,0,0,0
23:05:25,3,999,500,541,0,2040
23:05:26,3,999,503,541,1,2044
23:05:27,3,0,0,0,0,0
23:05:28,3,0,0,0,0,0
23:05:29,3,0,0,0,0,0
23:05:30,3,0,0,0,0,0
23:05:31,3,0,0,0,0,0
23:05:32,3,999,488,541,0,2028
23:05:33,3,0,0,0,0,0
23:05:34,3,999,492,540,0,2031
23:05:35,3,0,0,0,0,0
23:05:36,3,0,0,0,0,0
23:05:37,3,999,488,540,1,2028
23:05:38,3,999,501,539,1,2040
23:05:39,3,0,0,0,0,0
23:05:40,3,0,0,0,0,0
23:05:41,3,998,496,540,1,2035
23:05:42,3,999,485,540,0,2024
23:05:43,3,0,0,0,0,0
23:05:44,3,0,0,0,0,0
23:05:45,3,0,0,0,0,0
23:05:46,3,0,0,0,0,0
23:05:47,3,1000,492,539,1,2032
23:05:48,3,0,0,0,0,0
23:05:49,3,0,0,0,0,0
23:05:50,3,1000,493,539,1,2033
23:05:51,3,0,0,0,0,0
23:05:52,3,0,0,0,0,0
23:05:53,3,1000,501,539,1,2041
23:05:54,3,1000,492,539,2,2033
23:05:55,3,0,0,0,0,0
23:05:56,3,1001,492,539,0,2032
23:05:57,3,1000,491,539,0,2030
23:05:58,3,0,0,0,0,0
23:05:59,3,0,0,0,0,0
23:06:00,3,1000,500,539,1,2040
23:06:01,3,1000,493,540,0,2033
23:06:02,3,999,498,539,2,2038
23:06:03,3,992,499,540,0,2031
23:06:04,3,0,0,0,0,0
23:06:05,3,0,0,0,0,0
23:06:06,3,0,0,0,0,0
23:06:07,3,0,0,0,0,0
23:06:08,3,1000,498,540,2,2040
23:06:09,3,1000,506,540,0,2046
23:06:10,3,0,0,0,0,0
23:06:11,3,0,0,0,0,0
23:06:12,3,1001,502,539,1,2043
23:06:13,3,0,0,0,0,0
23:06:14,3,0,0,0,0,0
23:06:15,3,1000,512,540,0,2052
23:06:16,3,1001,502,539,1,2043
23:06:17,3,0,0,0,0,0
23:06:18,3,998,498,539,0,2035
23:06:19,3,0,0,0,0,0
23:06:20,3,1002,497,539,1,2039
23:06:21,3,0,0,0,0,0
23:06:22,3,0,0,0,0,0
23:06:23,3,0,0,0,0,0
23:06:24,3,1001,508,539,0,2048
23:06:25,3,0,0,0,0,0
23:06:26,3,1002,486,539,1,2028
23:06:27,3,0,0,0,0,0
23:06:28,3,0,0,0,0,0
23:06:29,3,1002,493,539,2,2036
23:06:30,3,0,0,0,0,0
23:06:31,3,0,0,0,0,0
23:06:32,3,1002,473,539,2,2016
23:06:33,3,0,0,0,0,0
23:06:34,3,1002,495,539,1,2037
23:06:35,3,0,0,0,0,0
23:06:36,3,1002,507,539,2,2050
23:06:37,3,0,0,0,0,0
23:06:38,3,0,0,0,0,0
23:06:39,3,0,0,0,0,0
23:06:40,3,1002,497,538,0,2037
23:06:41,3,1002,505,539,0,2046
23:06:42,3,0,0,0,0,0
23:06:43,3,0,0,0,0,0
23:06:44,3,0,0,0,0,0
23:06:45,3,1002,496,538,1,2037
23:06:46,3,0,0,0,0,0
23:06:47,3,1003,518,539,0,2060
23:06:48,3,1003,493,539,1,2036
23:06:49,3,1003,497,538,0,2038
23:06:50,3,0,0,0,0,0
23:06:51,3,0,0,0,0,0
23:06:52,3,0,0,0,0,0
23:06:53,3,1003,509,538,0,2050
23:06:54,3,0,0,0,0,0
23:06:55,3,1003,495,538,1,2037
23:06:56,3,1003,493,539,1,2036
23:06:57,3,1003,506,538,0,2047
23:06:58,3,1003,482,538,0,2023
23:06:59,3,1004,501,538,0,2043
23:07:00,3,1003,500,538,1,2042
23:07:01,3,1003,494,538,1,2036
23:07:02,3,0,0,0,0,0
23:07:03,3,0,0,0,0,0
23:07:04,3,1003,482,539,1,2025
23:07:05,3,998,483,540,0,2021
22:50:41,4,0,0,0,0,0
22:50:42,4,1001,497,550,0,2048
22:50:43,4,1001,498,550,0,2049
22:50:44,4,1001,552,550,0,2103
22:50:45,4,0,0,0,0,0
22:50:46,4,0,0,0,0,0
22:50:47,4,1001,497,550,0,2048
22:50:48,4,1001,500,550,0,2051
22:50:49,4,0,0,0,0,0
22:50:50,4,0,0,0,0,0
22:50:51,4,0,0,0,0,0
22:50:52,4,0,0,0,0,0
22:50:53,4,0,0,0,0,0
22:50:54,4,0,0,0,0,0
22:50:55,4,0,0,0,0,0
22:50:56,4,1000,383,550,0,1933
22:50:57,4,0,0,0,0,0
22:50:58,4,1001,497,550,0,2048
22:50:59,4,1001,497,550,0,2048
22:51:00,4,1001,498,550,0,2049
22:51:01,4,0,0,0,0,0
22:51:02,4,0,0,0,0,0
22:51:03,4,1001,500,550,0,2051
22:51:04,4,0,0,0,0,0
22:51:05,4,1001,492,550,0,2043
22:51:06,4,1001,489,550,0,2040
22:51:07,4,0,0,0,0,0
22:51:08,4,1001,493,550,0,2044
22:51:09,4,0,0,0,0,0
22:51:10,4,1001,501,550,0,2052
22:51:11,4,1001,500,549,0,2050
22:51:12,4,1001,507,550,0,2058
22:51:13,4,1001,505,550,0,2056
22:51:14,4,0,0,0,0,0
22:51:15,4,1001,489,549,0,2039
22:51:16,4,1001,492,550,0,2043
22:51:17,4,0,0,0,0,0
22:51:18,4,1001,503,549,0,2053
22:51:19,4,0,0,0,0,0
22:51:20,4,1000,475,549,0,2024
22:51:21,4,1001,505,549,0,2055
22:51:22,4,0,0,0,0,0
22:51:23,4,1001,243,549,0,1793
22:51:24,4,0,0,0,0,0
22:51:25,4,1001,529,549,0,2079
22:51:26,4,1000,414,549,0,1963
22:51:27,4,1001,496,550,0,2047
22:51:28,4,1001,495,549,0,2045
22:51:29,4,1001,503,549,0,2053
22:51:30,4,1000,496,549,0,2045
22:51:31,4,1001,491,549,0,2041
22:51:32,4,1001,496,549,0,2046
22:51:33,4,1001,500,549,0,2050
22:51:34,4,1001,461,549,0,2011
22:51:35,4,1001,500,549,0,2050
22:51:36,4,1001,502,549,0,2052
22:51:37,4,1000,515,549,0,2064
22:51:38,4,1000,495,549,93,2137
22:51:39,4,1000,496,549,178,2223
22:51:40,4,0,0,0,0,0
22:51:41,4,1001,493,549,663,2706
22:51:42,4,1001,492,549,486,2528
22:51:43,4,1001,497,549,711,2758
22:51:44,4,1000,496,549,599,2644
22:51:45,4,0,0,0,0,0
22:51:46,4,1001,499,549,521,2570
22:51:47,4,1001,489,549,470,2509
22:51:48,4,1001,499,549,445,2494
22:51:49,4,1001,494,549,509,2553
22:51:50,4,1001,493,549,505,2548
22:51:51,4,0,0,0,0,0
22:51:52,4,0,0,0,0,0
22:51:53,4,0,0,0,0,0
22:51:54,4,1001,478,549,458,2486
22:51:55,4,1001,492,549,408,2450
22:51:56,4,0,0,0,0,0
22:51:57,4,0,0,0,0,0
22:51:58,4,1007,508,569,621,2705
22:51:59,4,0,0,0,0,0
22:52:00,4,0,0,0,0,0
22:52:01,4,1011,503,633,429,2576
22:52:02,4,0,0,0,0,0
22:52:03,4,0,0,0,0,0
22:52:04,4,0,0,0,0,0
22:52:05,4,1007,465,723,526,2721
22:52:06,4,1008,486,727,499,2720
22:52:07,4,1007,437,729,509,2682
22:52:08,4,0,0,0,0,0
22:52:09,4,0,0,0,0,0
22:52:10,4,0,0,0,0,0
22:52:11,4,0,0,0,0,0
22:52:12,4,0,0,0,0,0
22:52:13,4,0,0,0,0,0
22:52:14,4,0,0,0,0,0
22:52:15,4,0,0,0,0,0
22:52:16,4,0,0,0,0,0
22:52:17,4,0,0,0,0,0
22:52:18,4,0,0,0,0,0
22:52:19,4,0,0,0,0,0
22:52:20,4,0,0,0,0,0
22:52:21,4,0,0,0,0,0
22:52:22,4,0,0,0,0,0
22:52:23,4,0,0,0,0,0
22:52:24,4,0,0,0,0,0
22:52:25,4,0,0,0,0,0
22:52:26,4,0,0,0,0,0
22:52:27,4,0,0,0,0,0
22:52:28,4,0,0,0,0,0
22:52:29,4,0,0,0,0,0
22:52:30,4,0,0,0,0,0
22:52:31,4,0,0,0,0,0
22:52:32,4,0,0,0,0,0
22:52:33,4,0,0,0,0,0
22:52:34,4,0,0,0,0,0
22:52:35,4,0,0,0,0,0
22:52:36,4,0,0,0,0,0
22:52:37,4,0,0,0,0,0
22:52:38,4,0,0,0,0,0
22:52:39,4,0,0,0,0,0
22:52:40,4,0,0,0,0,0
22:52:41,4,0,0,0,0,0
22:52:42,4,0,0,0,0,0
22:52:43,4,0,0,0,0,0
22:52:44,4,0,0,0,0,0
22:52:45,4,0,0,0,0,0
22:52:46,4,0,0,0,0,0
22:52:47,4,0,0,0,0,0
22:52:48,4,0,0,0,0,0
22:52:49,4,0,0,0,0,0
22:52:50,4,0,0,0,0,0
22:52:51,4,0,0,0,0,0
22:52:52,4,0,0,0,0,0
22:52:53,4,0,0,0,0,0
22:52:54,4,0,0,0,0,0
22:52:55,4,0,0,0,0,0
22:52:56,4,0,0,0,0,0
22:52:57,4,0,0,0,0,0
22:52:58,4,0,0,0,0,0
22:52:59,4,0,0,0,0,0
22:53:00,4,0,0,0,0,0
22:53:01,4,0,0,0,0,0
22:53:02,4,0,0,0,0,0
22:53:03,4,0,0,0,0,0
22:53:04,4,0,0,0,0,0
22:53:05,4,0,0,0,0,0
22:53:06,4,0,0,0,0,0
22:53:07,4,0,0,0,0,0
22:53:08,4,0,0,0,0,0
22:53:09,4,0,0,0,0,0
22:53:10,4,0,0,0,0,0
22:53:11,4,0,0,0,0,0
22:53:12,4,0,0,0,0,0
22:53:13,4,0,0,0,0,0
22:53:14,4,0,0,0,0,0
22:53:15,4,0,0,0,0,0
22:53:16,4,0,0,0,0,0
22:53:17,4,0,0,0,0,0
22:53:18,4,0,0,0,0,0
22:53:19,4,0,0,0,0,0
22:53:20,4,0,0,0,0,0
22:53:21,4,0,0,0,0,0
22:53:22,4,0,0,0,0,0
22:53:23,4,0,0,0,0,0
22:53:24,4,0,0,0,0,0
22:53:25,4,0,0,0,0,0
22:53:26,4,0,0,0,0,0
22:53:27,4,0,0,0,0,0
22:53:28,4,0,0,0,0,0
22:53:29,4,0,0,0,0,0
22:53:30,4,0,0,0,0,0
22:53:31,4,0,0,0,0,0
22:53:32,4,0,0,0,0,0
22:53:33,4,0,0,0,0,0
22:53:34,4,0,0,0,0,0
22:53:35,4,0,0,0,0,0
22:53:36,4,0,0,0,0,0
22:53:37,4,0,0,0,0,0
22:53:38,4,0,0,0,0,0
22:53:39,4,0,0,0,0,0
22:53:40,4,0,0,0,0,0
22:53:41,4,0,0,0,0,0
22:53:42,4,0,0,0,0,0
22:53:43,4,0,0,0,0,0
22:53:44,4,0,0,0,0,0
22:53:45,4,0,0,0,0,0
22:53:46,4,0,0,0,0,0
22:53:47,4,0,0,0,0,0
22:53:48,4,0,0,0,0,0
22:53:49,4,0,0,0,0,0
22:53:50,4,0,0,0,0,0
22:53:51,4,0,0,0,0,0
22:53:52,4,0,0,0,0,0
22:53:53,4,0,0,0,0,0
22:53:54,4,0,0,0,0,0
22:53:55,4,0,0,0,0,0
22:53:56,4,0,0,0,0,0
22:53:57,4,0,0,0,0,0
22:53:58,4,0,0,0,0,0
22:53:59,4,0,0,0,0,0
22:54:00,4,0,0,0,0,0
22:54:01,4,0,0,0,0,0
22:54:02,4,0,0,0,0,0
22:54:03,4,0,0,0,0,0
22:54:04,4,0,0,0,0,0
22:54:05,4,0,0,0,0,0
22:54:06,4,0,0,0,0,0
22:54:07,4,0,0,0,0,0
22:54:08,4,0,0,0,0,0
22:54:09,4,0,0,0,0,0
22:54:10,4,0,0,0,0,0
22:54:11,4,0,0,0,0,0
22:54:12,4,0,0,0,0,0
22:54:13,4,0,0,0,0,0
22:54:14,4,0,0,0,0,0
22:54:15,4,0,0,0,0,0
22:54:16,4,0,0,0,0,0
22:54:17,4,0,0,0,0,0
22:54:18,4,0,0,0,0,0
22:54:19,4,0,0,0,0,0
22:54:20,4,0,0,0,0,0
22:54:21,4,0,0,0,0,0
22:54:22,4,0,0,0,0,0
22:54:23,4,0,0,0,0,0
22:54:24,4,0,0,0,0,0
22:54:25,4,0,0,0,0,0
22:54:26,4,0,0,0,0,0
22:54:27,4,0,0,0,0,0
22:54:28,4,0,0,0,0,0
22:54:29,4,0,0,0,0,0
22:54:30,4,0,0,0,0,0
22:54:31,4,0,0,0,0,0
22:54:32,4,0,0,0,0,0
22:54:33,4,0,0,0,0,0
22:54:34,4,0,0,0,0,0
22:54:35,4,0,0,0,0,0
22:54:36,4,0,0,0,0,0
22:54:37,4,0,0,0,0,0
22:54:38,4,0,0,0,0,0
22:54:39,4,0,0,0,0,0
22:54:40,4,0,0,0,0,0
22:54:41,4,0,0,0,0,0
22:54:42,4,0,0,0,0,0
22:54:43,4,0,0,0,0,0
22:54:44,4,0,0,0,0,0
22:54:45,4,0,0,0,0,0
22:54:46,4,0,0,0,0,0
22:54:47,4,0,0,0,0,0
22:54:48,4,0,0,0,0,0
22:54:49,4,0,0,0,0,0
22:54:50,4,0,0,0,0,0
22:54:51,4,0,0,0,0,0
22:54:52,4,0,0,0,0,0
22:54:53,4,0,0,0,0,0
22:54:54,4,0,0,0,0,0
22:54:55,4,0,0,0,0,0
22:54:56,4,0,0,0,0,0
22:54:57,4,0,0,0,0,0
22:54:58,4,0,0,0,0,0
22:54:59,4,0,0,0,0,0
22:55:00,4,0,0,0,0,0
22:55:01,4,0,0,0,0,0
22:55:02,4,0,0,0,0,0
22:55:03,4,0,0,0,0,0
22:55:04,4,0,0,0,0,0
22:55:05,4,0,0,0,0,0
22:55:06,4,0,0,0,0,0
22:55:07,4,0,0,0,0,0
22:55:08,4,0,0,0,0,0
22:55:09,4,0,0,0,0,0
22:55:10,4,0,0,0,0,0
22:55:11,4,0,0,0,0,0
22:55:12,4,0,0,0,0,0
22:55:13,4,0,0,0,0,0
22:55:14,4,0,0,0,0,0
22:55:15,4,0,0,0,0,0
22:55:16,4,0,0,0,0,0
22:55:17,4,0,0,0,0,0
22:55:18,4,0,0,0,0,0
22:55:19,4,0,0,0,0,0
22:55:20,4,0,0,0,0,0
22:55:21,4,0,0,0,0,0
22:55:22,4,0,0,0,0,0
22:55:23,4,0,0,0,0,0
22:55:24,4,0,0,0,0,0
22:55:25,4,0,0,0,0,0
22:55:26,4,0,0,0,0,0
22:55:27,4,0,0,0,0,0
22:55:28,4,0,0,0,0,0
22:55:29,4,0,0,0,0,0
22:55:30,4,0,0,0,0,0
22:55:31,4,0,0,0,0,0
22:55:32,4,0,0,0,0,0
22:55:33,4,0,0,0,0,0
22:55:34,4,0,0,0,0,0
22:55:35,4,0,0,0,0,0
22:55:36,4,0,0,0,0,0
22:55:37,4,0,0,0,0,0
22:55:38,4,0,0,0,0,0
22:55:39,4,0,0,0,0,0
22:55:40,4,0,0,0,0,0
22:55:41,4,0,0,0,0,0
22:55:42,4,0,0,0,0,0
22:55:43,4,0,0,0,0,0
22:55:44,4,0,0,0,0,0
22:55:45,4,0,0,0,0,0
22:55:46,4,0,0,0,0,0
22:55:47,4,0,0,0,0,0
22:55:48,4,0,0,0,0,0
22:55:49,4,0,0,0,0,0
22:55:50,4,0,0,0,0,0
22:55:51,4,0,0,0,0,0
22:55:52,4,0,0,0,0,0
22:55:53,4,0,0,0,0,0
22:55:54,4,0,0,0,0,0
22:55:55,4,0,0,0,0,0
22:55:56,4,0,0,0,0,0
22:55:57,4,0,0,0,0,0
22:55:58,4,0,0,0,0,0
22:55:59,4,0,0,0,0,0
22:56:00,4,0,0,0,0,0
22:56:01,4,0,0,0,0,0
22:56:02,4,0,0,0,0,0
22:56:03,4,0,0,0,0,0
22:56:04,4,0,0,0,0,0
22:56:05,4,0,0,0,0,0
22:56:06,4,0,0,0,0,0
22:56:07,4,0,0,0,0,0
22:56:08,4,0,0,0,0,0
22:56:09,4,0,0,0,0,0
22:56:10,4,0,0,0,0,0
22:56:11,4,0,0,0,0,0
22:56:12,4,0,0,0,0,0
22:56:13,4,0,0,0,0,0
22:56:14,4,0,0,0,0,0
22:56:15,4,0,0,0,0,0
22:56:16,4,0,0,0,0,0
22:56:17,4,0,0,0,0,0
22:56:18,4,0,0,0,0,0
22:56:19,4,0,0,0,0,0
22:56:20,4,0,0,0,0,0
22:56:21,4,0,0,0,0,0
22:56:22,4,0,0,0,0,0
22:56:23,4,0,0,0,0,0
22:56:24,4,0,0,0,0,0
22:56:25,4,0,0,0,0,0
22:56:26,4,0,0,0,0,0
22:56:27,4,0,0,0,0,0
22:56:28,4,0,0,0,0,0
22:56:29,4,0,0,0,0,0
22:56:30,4,0,0,0,0,0
22:56:31,4,0,0,0,0,0
22:56:32,4,0,0,0,0,0
22:56:33,4,0,0,0,0,0
22:56:34,4,0,0,0,0,0
22:56:35,4,0,0,0,0,0
22:56:36,4,0,0,0,0,0
22:56:37,4,0,0,0,0,0
22:56:38,4,0,0,0,0,0
22:56:39,4,0,0,0,0,0
22:56:40,4,0,0,0,0,0
22:56:41,4,0,0,0,0,0
22:56:42,4,0,0,0,0,0
22:56:43,4,0,0,0,0,0
22:56:44,4,0,0,0,0,0
22:56:45,4,0,0,0,0,0
22:56:46,4,0,0,0,0,0
22:56:47,4,0,0,0,0,0
22:56:48,4,0,0,0,0,0
22:56:49,4,0,0,0,0,0
22:56:50,4,0,0,0,0,0
22:56:51,4,0,0,0,0,0
22:56:52,4,0,0,0,0,0
22:56:53,4,0,0,0,0,0
22:56:54,4,0,0,0,0,0
22:56:55,4,0,0,0,0,0
22:56:56,4,0,0,0,0,0
22:56:57,4,0,0,0,0,0
22:56:58,4,0,0,0,0,0
22:56:59,4,0,0,0,0,0
22:57:00,4,0,0,0,0,0
22:57:01,4,0,0,0,0,0
22:57:02,4,0,0,0,0,0
22:57:03,4,0,0,0,0,0
22:57:04,4,0,0,0,0,0
22:57:05,4,0,0,0,0,0
22:57:06,4,0,0,0,0,0
22:57:07,4,0,0,0,0,0
22:57:08,4,0,0,0,0,0
22:57:09,4,0,0,0,0,0
22:57:10,4,0,0,0,0,0
22:57:11,4,0,0,0,0,0
22:57:12,4,0,0,0,0,0
22:57:13,4,0,0,0,0,0
22:57:14,4,0,0,0,0,0
22:57:15,4,0,0,0,0,0
22:57:16,4,0,0,0,0,0
22:57:17,4,0,0,0,0,0
22:57:18,4,0,0,0,0,0
22:57:19,4,0,0,0,0,0
22:57:20,4,0,0,0,0,0
22:57:21,4,0,0,0,0,0
22:57:22,4,0,0,0,0,0
22:57:23,4,0,0,0,0,0
22:57:24,4,0,0,0,0,0
22:57:25,4,0,0,0,0,0
22:57:26,4,0,0,0,0,0
22:57:27,4,0,0,0,0,0
22:57:28,4,0,0,0,0,0
22:57:29,4,0,0,0,0,0
22:57:30,4,0,0,0,0,0
22:57:31,4,0,0,0,0,0
22:57:32,4,0,0,0,0,0
22:57:33,4,0,0,0,0,0
22:57:34,4,0,0,0,0,0
22:57:35,4,0,0,0,0,0
22:57:36,4,0,0,0,0,0
22:57:37,4,0,0,0,0,0
22:57:38,4,0,0,0,0,0
22:57:39,4,0,0,0,0,0
22:57:40,4,0,0,0,0,0
22:57:41,4,0,0,0,0,0
22:57:42,4,0,0,0,0,0
22:57:43,4,0,0,0,0,0
22:57:44,4,0,0,0,0,0
22:57:45,4,0,0,0,0,0
22:57:46,4,0,0,0,0,0
22:57:47,4,0,0,0,0,0
22:57:48,4,0,0,0,0,0
22:57:49,4,0,0,0,0,0
22:57:50,4,0,0,0,0,0
22:57:51,4,0,0,0,0,0
22:57:52,4,0,0,0,0,0
22:57:53,4,0,0,0,0,0
22:57:54,4,0,0,0,0,0
22:57:55,4,0,0,0,0,0
22:57:56,4,0,0,0,0,0
22:57:57,4,0,0,0,0,0
22:57:58,4,0,0,0,0,0
22:57:59,4,0,0,0,0,0
22:58:00,4,0,0,0,0,0
22:58:01,4,0,0,0,0,0
22:58:02,4,0,0,0,0,0
22:58:03,4,0,0,0,0,0
22:58:04,4,0,0,0,0,0
22:58:05,4,0,0,0,0,0
22:58:06,4,0,0,0,0,0
22:58:07,4,0,0,0,0,0
22:58:08,4,0,0,0,0,0
22:58:09,4,0,0,0,0,0
22:58:10,4,0,0,0,0,0
22:58:11,4,0,0,0,0,0
22:58:12,4,0,0,0,0,0
22:58:13,4,0,0,0,0,0
22:58:14,4,0,0,0,0,0
22:58:15,4,0,0,0,0,0
22:58:16,4,0,0,0,0,0
22:58:17,4,0,0,0,0,0
22:58:18,4,0,0,0,0,0
22:58:19,4,0,0,0,0,0
22:58:20,4,0,0,0,0,0
22:58:21,4,0,0,0,0,0
22:58:22,4,0,0,0,0,0
22:58:23,4,0,0,0,0,0
22:58:24,4,0,0,0,0,0
22:58:25,4,0,0,0,0,0
22:58:26,4,0,0,0,0,0
22:58:27,4,0,0,0,0,0
22:58:28,4,0,0,0,0,0
22:58:29,4,0,0,0,0,0
22:58:30,4,0,0,0,0,0
22:58:31,4,0,0,0,0,0
22:58:32,4,0,0,0,0,0
22:58:33,4,0,0,0,0,0
22:58:34,4,0,0,0,0,0
22:58:35,4,0,0,0,0,0
22:58:36,4,0,0,0,0,0
22:58:37,4,0,0,0,0,0
22:58:38,4,0,0,0,0,0
22:58:39,4,0,0,0,0,0
22:58:40,4,0,0,0,0,0
22:58:41,4,0,0,0,0,0
22:58:42,4,0,0,0,0,0
22:58:43,4,0,0,0,0,0
22:58:44,4,0,0,0,0,0
22:58:45,4,0,0,0,0,0
22:58:46,4,0,0,0,0,0
22:58:47,4,0,0,0,0,0
22:58:48,4,0,0,0,0,0
22:58:49,4,0,0,0,0,0
22:58:50,4,0,0,0,0,0
22:58:51,4,0,0,0,0,0
22:58:52,4,0,0,0,0,0
22:58:53,4,0,0,0,0,0
22:58:54,4,0,0,0,0,0
22:58:55,4,0,0,0,0,0
22:58:56,4,0,0,0,0,0
22:58:57,4,0,0,0,0,0
22:58:58,4,0,0,0,0,0
22:58:59,4,0,0,0,0,0
22:59:00,4,0,0,0,0,0
22:59:01,4,0,0,0,0,0
22:59:02,4,0,0,0,0,0
22:59:03,4,0,0,0,0,0
22:59:04,4,0,0,0,0,0
22:59:05,4,0,0,0,0,0
22:59:06,4,0,0,0,0,0
22:59:07,4,0,0,0,0,0
22:59:08,4,0,0,0,0,0
22:59:09,4,0,0,0,0,0
22:59:10,4,0,0,0,0,0
22:59:11,4,0,0,0,0,0
22:59:12,4,0,0,0,0,0
22:59:13,4,0,0,0,0,0
22:59:14,4,0,0,0,0,0
22:59:15,4,0,0,0,0,0
22:59:16,4,0,0,0,0,0
22:59:17,4,0,0,0,0,0
22:59:18,4,0,0,0,0,0
22:59:19,4,0,0,0,0,0
22:59:20,4,0,0,0,0,0
22:59:21,4,0,0,0,0,0
22:59:22,4,0,0,0,0,0
22:59:23,4,0,0,0,0,0
22:59:24,4,0,0,0,0,0
22:59:25,4,0,0,0,0,0
22:59:26,4,0,0,0,0,0
22:59:27,4,0,0,0,0,0
22:59:28,4,0,0,0,0,0
22:59:29,4,0,0,0,0,0
22:59:30,4,0,0,0,0,0
22:59:31,4,0,0,0,0,0
22:59:32,4,0,0,0,0,0
22:59:33,4,0,0,0,0,0
22:59:34,4,0,0,0,0,0
22:59:35,4,0,0,0,0,0
22:59:36,4,0,0,0,0,0
22:59:37,4,0,0,0,0,0
22:59:38,4,0,0,0,0,0
22:59:39,4,0,0,0,0,0
22:59:40,4,0,0,0,0,0
22:59:41,4,0,0,0,0,0
22:59:42,4,0,0,0,0,0
22:59:43,4,0,0,0,0,0
22:59:44,4,0,0,0,0,0
22:59:45,4,0,0,0,0,0
22:59:46,4,0,0,0,0,0
22:59:47,4,0,0,0,0,0
22:59:48,4,0,0,0,0,0
22:59:49,4,0,0,0,0,0
22:59:50,4,0,0,0,0,0
22:59:51,4,0,0,0,0,0
22:59:52,4,0,0,0,0,0
22:59:53,4,0,0,0,0,0
22:59:54,4,0,0,0,0,0
22:59:55,4,0,0,0,0,0
22:59:56,4,0,0,0,0,0
22:59:57,4,0,0,0,0,0
22:59:58,4,0,0,0,0,0
22:59:59,4,0,0,0,0,0
23:00:00,4,0,0,0,0,0
23:00:01,4,0,0,0,0,0
23:00:02,4,0,0,0,0,0
23:00:03,4,0,0,0,0,0
23:00:04,4,0,0,0,0,0
23:00:05,4,0,0,0,0,0
23:00:06,4,0,0,0,0,0
23:00:07,4,0,0,0,0,0
23:00:08,4,0,0,0,0,0
23:00:09,4,0,0,0,0,0
23:00:10,4,0,0,0,0,0
23:00:11,4,0,0,0,0,0
23:00:12,4,0,0,0,0,0
23:00:13,4,0,0,0,0,0
23:00:14,4,0,0,0,0,0
23:00:15,4,0,0,0,0,0
23:00:16,4,0,0,0,0,0
23:00:17,4,0,0,0,0,0
23:00:18,4,0,0,0,0,0
23:00:19,4,0,0,0,0,0
23:00:20,4,0,0,0,0,0
23:00:21,4,0,0,0,0,0
23:00:22,4,0,0,0,0,0
23:00:23,4,0,0,0,0,0
23:00:24,4,0,0,0,0,0
23:00:25,4,0,0,0,0,0
23:00:26,4,0,0,0,0,0
23:00:27,4,0,0,0,0,0
23:00:28,4,0,0,0,0,0
23:00:29,4,0,0,0,0,0
23:00:30,4,0,0,0,0,0
23:00:31,4,0,0,0,0,0
23:00:32,4,0,0,0,0,0
23:00:33,4,0,0,0,0,0
23:00:34,4,0,0,0,0,0
23:00:35,4,0,0,0,0,0
23:00:36,4,0,0,0,0,0
23:00:37,4,0,0,0,0,0
23:00:38,4,0,0,0,0,0
23:00:39,4,0,0,0,0,0
23:00:40,4,0,0,0,0,0
23:00:41,4,0,0,0,0,0
23:00:42,4,0,0,0,0,0
23:00:43,4,0,0,0,0,0
23:00:44,4,0,0,0,0,0
23:00:45,4,0,0,0,0,0
23:00:46,4,0,0,0,0,0
23:00:47,4,0,0,0,0,0
23:00:48,4,0,0,0,0,0
23:00:49,4,0,0,0,0,0
23:00:50,4,0,0,0,0,0
23:00:51,4,0,0,0,0,0
23:00:52,4,0,0,0,0,0
23:00:53,4,0,0,0,0,0
23:00:54,4,0,0,0,0,0
23:00:55,4,0,0,0,0,0
23:00:56,4,0,0,0,0,0
23:00:57,4,0,0,0,0,0
23:00:58,4,0,0,0,0,0
23:00:59,4,0,0,0,0,0
23:01:00,4,0,0,0,0,0
23:01:01,4,0,0,0,0,0
23:01:02,4,0,0,0,0,0
23:01:03,4,0,0,0,0,0
23:01:04,4,0,0,0,0,0
23:01:05,4,0,0,0,0,0
23:01:06,4,0,0,0,0,0
23:01:07,4,0,0,0,0,0
23:01:08,4,0,0,0,0,0
23:01:09,4,0,0,0,0,0
23:01:10,4,0,0,0,0,0
23:01:11,4,0,0,0,0,0
23:01:12,4,0,0,0,0,0
23:01:13,4,0,0,0,0,0
23:01:14,4,0,0,0,0,0
23:01:15,4,0,0,0,0,0
23:01:16,4,0,0,0,0,0
23:01:17,4,0,0,0,0,0
23:01:18,4,0,0,0,0,0
23:01:19,4,0,0,0,0,0
23:01:20,4,0,0,0,0,0
23:01:21,4,0,0,0,0,0
23:01:22,4,0,0,0,0,0
23:01:23,4,0,0,0,0,0
23:01:24,4,0,0,0,0,0
23:01:25,4,0,0,0,0,0
23:01:26,4,0,0,0,0,0
23:01:27,4,0,0,0,0,0
23:01:28,4,0,0,0,0,0
23:01:29,4,0,0,0,0,0
23:01:30,4,0,0,0,0,0
23:01:31,4,0,0,0,0,0
23:01:32,4,0,0,0,0,0
23:01:33,4,0,0,0,0,0
23:01:34,4,0,0,0,0,0
23:01:35,4,0,0,0,0,0
23:01:36,4,0,0,0,0,0
23:01:37,4,0,0,0,0,0
23:01:38,4,0,0,0,0,0
23:01:39,4,0,0,0,0,0
23:01:40,4,0,0,0,0,0
23:01:41,4,0,0,0,0,0
23:01:42,4,0,0,0,0,0
23:01:43,4,0,0,0,0,0
23:01:44,4,0,0,0,0,0
23:01:45,4,0,0,0,0,0
23:01:46,4,0,0,0,0,0
23:01:47,4,0,0,0,0,0
23:01:48,4,0,0,0,0,0
23:01:49,4,0,0,0,0,0
23:01:50,4,0,0,0,0,0
23:01:51,4,0,0,0,0,0
23:01:52,4,0,0,0,0,0
23:01:53,4,0,0,0,0,0
23:01:54,4,0,0,0,0,0
23:01:55,4,0,0,0,0,0
23:01:56,4,0,0,0,0,0
23:01:57,4,0,0,0,0,0
23:01:58,4,0,0,0,0,0
23:01:59,4,0,0,0,0,0
23:02:00,4,0,0,0,0,0
23:02:01,4,0,0,0,0,0
23:02:02,4,0,0,0,0,0
23:02:03,4,0,0,0,0,0
23:02:04,4,0,0,0,0,0
23:02:05,4,0,0,0,0,0
23:02:06,4,0,0,0,0,0
23:02:07,4,0,0,0,0,0
23:02:08,4,0,0,0,0,0
23:02:09,4,0,0,0,0,0
23:02:10,4,0,0,0,0,0
23:02:11,4,0,0,0,0,0
23:02:12,4,0,0,0,0,0
23:02:13,4,0,0,0,0,0
23:02:14,4,0,0,0,0,0
23:02:15,4,0,0,0,0,0
23:02:16,4,0,0,0,0,0
23:02:17,4,0,0,0,0,0
23:02:18,4,0,0,0,0,0
23:02:19,4,0,0,0,0,0
23:02:20,4,0,0,0,0,0
23:02:21,4,0,0,0,0,0
23:02:22,4,0,0,0,0,0
23:02:23,4,0,0,0,0,0
23:02:24,4,0,0,0,0,0
23:02:25,4,0,0,0,0,0
23:02:26,4,0,0,0,0,0
23:02:27,4,0,0,0,0,0
23:02:28,4,0,0,0,0,0
23:02:29,4,0,0,0,0,0
23:02:30,4,0,0,0,0,0
23:02:31,4,0,0,0,0,0
23:02:32,4,0,0,0,0,0
23:02:33,4,0,0,0,0,0
23:02:34,4,0,0,0,0,0
23:02:35,4,0,0,0,0,0
23:02:36,4,0,0,0,0,0
23:02:37,4,0,0,0,0,0
23:02:38,4,0,0,0,0,0
23:02:39,4,0,0,0,0,0
23:02:40,4,0,0,0,0,0
23:02:41,4,0,0,0,0,0
23:02:42,4,0,0,0,0,0
23:02:43,4,0,0,0,0,0
23:02:44,4,0,0,0,0,0
23:02:45,4,0,0,0,0,0
23:02:46,4,0,0,0,0,0
23:02:47,4,0,0,0,0,0
23:02:48,4,0,0,0,0,0
23:02:49,4,0,0,0,0,0
23:02:50,4,0,0,0,0,0
23:02:51,4,0,0,0,0,0
23:02:52,4,0,0,0,0,0
23:02:53,4,0,0,0,0,0
23:02:54,4,0,0,0,0,0
23:02:55,4,0,0,0,0,0
23:02:56,4,0,0,0,0,0
23:02:57,4,0,0,0,0,0
23:02:58,4,0,0,0,0,0
23:02:59,4,0,0,0,0,0
23:03:00,4,0,0,0,0,0
23:03:01,4,0,0,0,0,0
23:03:02,4,0,0,0,0,0
23:03:03,4,0,0,0,0,0
23:03:04,4,0,0,0,0,0
23:03:05,4,0,0,0,0,0
23:03:06,4,0,0,0,0,0
23:03:07,4,0,0,0,0,0
23:03:08,4,0,0,0,0,0
23:03:09,4,0,0,0,0,0
23:03:10,4,0,0,0,0,0
23:03:11,4,0,0,0,0,0
23:03:12,4,0,0,0,0,0
23:03:13,4,0,0,0,0,0
23:03:14,4,0,0,0,0,0
23:03:15,4,0,0,0,0,0
23:03:16,4,0,0,0,0,0
23:03:17,4,0,0,0,0,0
23:03:18,4,0,0,0,0,0
23:03:19,4,0,0,0,0,0
23:03:20,4,0,0,0,0,0
23:03:21,4,0,0,0,0,0
23:03:22,4,0,0,0,0,0
23:03:23,4,0,0,0,0,0
23:03:24,4,0,0,0,0,0
23:03:25,4,0,0,0,0,0
23:03:26,4,0,0,0,0,0
23:03:27,4,0,0,0,0,0
23:03:28,4,0,0,0,0,0
23:03:29,4,0,0,0,0,0
23:03:30,4,0,0,0,0,0
23:03:31,4,0,0,0,0,0
23:03:32,4,0,0,0,0,0
23:03:33,4,0,0,0,0,0
23:03:34,4,0,0,0,0,0
23:03:35,4,0,0,0,0,0
23:03:36,4,0,0,0,0,0
23:03:37,4,0,0,0,0,0
23:03:38,4,0,0,0,0,0
23:03:39,4,0,0,0,0,0
23:03:40,4,0,0,0,0,0
23:03:41,4,0,0,0,0,0
23:03:42,4,0,0,0,0,0
23:03:43,4,0,0,0,0,0
23:03:44,4,0,0,0,0,0
23:03:45,4,0,0,0,0,0
23:03:46,4,0,0,0,0,0
23:03:47,4,0,0,0,0,0
23:03:48,4,0,0,0,0,0
23:03:49,4,0,0,0,0,0
23:03:50,4,0,0,0,0,0
23:03:51,4,0,0,0,0,0
23:03:52,4,0,0,0,0,0
23:03:53,4,0,0,0,0,0
23:03:54,4,0,0,0,0,0
23:03:55,4,0,0,0,0,0
23:03:56,4,0,0,0,0,0
23:03:57,4,0,0,0,0,0
23:03:58,4,0,0,0,0,0
23:03:59,4,0,0,0,0,0
23:04:00,4,0,0,0,0,0
23:04:01,4,0,0,0,0,0
23:04:02,4,0,0,0,0,0
23:04:03,4,0,0,0,0,0
23:04:04,4,0,0,0,0,0
23:04:05,4,0,0,0,0,0
23:04:06,4,0,0,0,0,0
23:04:07,4,0,0,0,0,0
23:04:08,4,0,0,0,0,0
23:04:09,4,0,0,0,0,0
23:04:10,4,0,0,0,0,0
23:04:11,4,0,0,0,0,0
23:04:12,4,0,0,0,0,0
23:04:13,4,0,0,0,0,0
23:04:14,4,0,0,0,0,0
23:04:15,4,0,0,0,0,0
23:04:16,4,0,0,0,0,0
23:04:17,4,0,0,0,0,0
23:04:18,4,0,0,0,0,0
23:04:19,4,0,0,0,0,0
23:04:20,4,0,0,0,0,0
23:04:21,4,0,0,0,0,0
23:04:22,4,0,0,0,0,0
23:04:23,4,0,0,0,0,0
23:04:24,4,0,0,0,0,0
23:04:25,4,0,0,0,0,0
23:04:26,4,0,0,0,0,0
23:04:27,4,0,0,0,0,0
23:04:28,4,0,0,0,0,0
23:04:29,4,0,0,0,0,0
23:04:30,4,0,0,0,0,0
23:04:31,4,0,0,0,0,0
23:04:32,4,0,0,0,0,0
23:04:33,4,0,0,0,0,0
23:04:34,4,0,0,0,0,0
23:04:35,4,0,0,0,0,0
23:04:36,4,0,0,0,0,0
23:04:37,4,0,0,0,0,0
23:04:38,4,0,0,0,0,0
23:04:39,4,0,0,0,0,0
23:04:40,4,0,0,0,0,0
23:04:41,4,0,0,0,0,0
23:04:42,4,0,0,0,0,0
23:04:43,4,0,0,0,0,0
23:04:44,4,0,0,0,0,0
23:04:45,4,0,0,0,0,0
23:04:46,4,0,0,0,0,0
23:04:47,4,0,0,0,0,0
23:04:48,4,0,0,0,0,0
23:04:49,4,0,0,0,0,0
23:04:50,4,0,0,0,0,0
23:04:51,4,0,0,0,0,0
23:04:52,4,0,0,0,0,0
23:04:53,4,0,0,0,0,0
23:04:54,4,0,0,0,0,0
23:04:55,4,0,0,0,0,0
23:04:56,4,0,0,0,0,0
23:04:57,4,0,0,0,0,0
23:04:58,4,0,0,0,0,0
23:04:59,4,0,0,0,0,0
23:05:00,4,0,0,0,0,0
23:05:01,4,0,0,0,0,0
23:05:02,4,0,0,0,0,0
23:05:03,4,0,0,0,0,0
23:05:04,4,0,0,0,0,0
23:05:05,4,0,0,0,0,0
23:05:06,4,0,0,0,0,0
23:05:07,4,0,0,0,0,0
23:05:08,4,0,0,0,0,0
23:05:09,4,0,0,0,0,0
23:05:10,4,0,0,0,0,0
23:05:11,4,0,0,0,0,0
23:05:12,4,0,0,0,0,0
23:05:13,4,0,0,0,0,0
23:05:14,4,0,0,0,0,0
23:05:15,4,0,0,0,0,0
23:05:16,4,0,0,0,0,0
23:05:17,4,0,0,0,0,0
23:05:18,4,0,0,0,0,0
23:05:19,4,0,0,0,0,0
23:05:20,4,0,0,0,0,0
23:05:21,4,0,0,0,0,0
23:05:22,4,0,0,0,0,0
23:05:23,4,0,0,0,0,0
23:05:24,4,0,0,0,0,0
23:05:25,4,0,0,0,0,0
23:05:26,4,0,0,0,0,0
23:05:27,4,0,0,0,0,0
23:05:28,4,0,0,0,0,0
23:05:29,4,0,0,0,0,0
23:05:30,4,0,0,0,0,0
23:05:31,4,0,0,0,0,0
23:05:32,4,0,0,0,0,0
23:05:33,4,0,0,0,0,0
23:05:34,4,0,0,0,0,0
23:05:35,4,0,0,0,0,0
23:05:36,4,0,0,0,0,0
23:05:37,4,0,0,0,0,0
23:05:38,4,0,0,0,0,0
23:05:39,4,0,0,0,0,0
23:05:40,4,0,0,0,0,0
23:05:41,4,0,0,0,0,0
23:05:42,4,0,0,0,0,0
23:05:43,4,0,0,0,0,0
23:05:44,4,0,0,0,0,0
23:05:45,4,0,0,0,0,0
23:05:46,4,0,0,0,0,0
23:05:47,4,0,0,0,0,0
23:05:48,4,0,0,0,0,0
23:05:49,4,0,0,0,0,0
23:05:50,4,0,0,0,0,0
23:05:51,4,0,0,0,0,0
23:05:52,4,0,0,0,0,0
23:05:53,4,0,0,0,0,0
23:05:54,4,0,0,0,0,0
23:05:55,4,0,0,0,0,0
23:05:56,4,0,0,0,0,0
23:05:57,4,0,0,0,0,0
23:05:58,4,0,0,0,0,0
23:05:59,4,0,0,0,0,0
23:06:00,4,0,0,0,0,0
23:06:01,4,0,0,0,0,0
23:06:02,4,0,0,0,0,0
23:06:03,4,0,0,0,0,0
23:06:04,4,0,0,0,0,0
23:06:05,4,0,0,0,0,0
23:06:06,4,0,0,0,0,0
23:06:07,4,0,0,0,0,0
23:06:08,4,0,0,0,0,0
23:06:09,4,0,0,0,0,0
23:06:10,4,0,0,0,0,0
23:06:11,4,0,0,0,0,0
23:06:12,4,0,0,0,0,0
23:06:13,4,0,0,0,0,0
23:06:14,4,0,0,0,0,0
23:06:15,4,0,0,0,0,0
23:06:16,4,0,0,0,0,0
23:06:17,4,0,0,0,0,0
23:06:18,4,0,0,0,0,0
23:06:19,4,0,0,0,0,0
23:06:20,4,0,0,0,0,0
23:06:21,4,0,0,0,0,0
23:06:22,4,0,0,0,0,0
23:06:23,4,0,0,0,0,0
23:06:24,4,0,0,0,0,0
23:06:25,4,0,0,0,0,0
23:06:26,4,0,0,0,0,0
23:06:27,4,0,0,0,0,0
23:06:28,4,0,0,0,0,0
23:06:29,4,0,0,0,0,0
23:06:30,4,0,0,0,0,0
23:06:31,4,0,0,0,0,0
23:06:32,4,0,0,0,0,0
23:06:33,4,0,0,0,0,0
23:06:34,4,0,0,0,0,0
23:06:35,4,0,0,0,0,0
23:06:36,4,0,0,0,0,0
23:06:37,4,0,0,0,0,0
23:06:38,4,0,0,0,0,0
23:06:39,4,0,0,0,0,0
23:06:40,4,0,0,0,0,0
23:06:41,4,0,0,0,0,0
23:06:42,4,0,0,0,0,0
23:06:43,4,0,0,0,0,0
23:06:44,4,0,0,0,0,0
23:06:45,4,0,0,0,0,0
23:06:46,4,0,0,0,0,0
23:06:47,4,0,0,0,0,0
23:06:48,4,0,0,0,0,0
23:06:49,4,0,0,0,0,0
23:06:50,4,0,0,0,0,0
23:06:51,4,0,0,0,0,0
23:06:52,4,0,0,0,0,0
23:06:53,4,0,0,0,0,0
23:06:54,4,0,0,0,0,0
23:06:55,4,0,0,0,0,0
23:06:56,4,0,0,0,0,0
23:06:57,4,0,0,0,0,0
23:06:58,4,0,0,0,0,0
23:06:59,4,0,0,0,0,0
23:07:00,4,0,0,0,0,0
23:07:01,4,0,0,0,0,0
23:07:02,4,0,0,0,0,0
23:07:03,4,0,0,0,0,0
23:07:04,4,0,0,0,0,0
23:07:05,4,1001,497,550,0,2048
22:50:41,5,0,0,0,0,0
22:50:42,5,1001,494,534,0,2029
22:50:43,5,1001,510,534,0,2045
22:50:44,5,1001,494,534,0,2029
22:50:45,5,1001,499,534,0,2034
22:50:46,5,1001,485,534,0,2020
22:50:47,5,1001,507,534,0,2042
22:50:48,5,1000,493,534,0,2027
22:50:49,5,0,0,0,0,0
22:50:50,5,1001,485,534,0,2020
22:50:51,5,1001,492,535,0,2028
22:50:52,5,1000,485,534,0,2019
22:50:53,5,999,544,535,0,2078
22:50:54,5,1000,384,535,0,1919
22:50:55,5,1000,476,535,0,2011
22:50:56,5,999,558,534,0,2091
22:50:57,5,999,498,534,0,2031
22:50:58,5,999,495,534,0,2028
22:50:59,5,999,462,535,0,1996
22:51:00,5,999,498,534,0,2031
22:51:01,5,999,484,535,0,2018
22:51:02,5,999,514,535,0,2048
22:51:03,5,1015,525,541,0,2081
22:51:04,5,0,0,0,0,0
22:51:05,5,999,481,539,0,2019
22:51:06,5,999,545,538,0,2082
22:51:07,5,999,454,538,0,1991
22:51:08,5,999,498,538,0,2035
22:51:09,5,999,492,537,0,2028
22:51:10,5,999,490,537,0,2026
22:51:11,5,1012,497,540,0,2049
22:51:12,5,1000,503,542,0,2045
22:51:13,5,1001,489,540,0,2030
22:51:14,5,1000,483,538,0,2021
22:51:15,5,1001,492,538,0,2031
22:51:16,5,1000,759,538,0,2297
22:51:17,5,1000,470,538,0,2008
22:51:18,5,1000,498,538,0,2036
22:51:19,5,1000,484,537,0,2021
22:51:20,5,1000,496,537,0,2033
22:51:21,5,1000,505,537,0,2042
22:51:22,5,1000,495,537,0,2032
22:51:23,5,999,592,537,0,2128
22:51:24,5,999,489,537,0,2025
22:51:25,5,999,491,537,0,2027
22:51:26,5,1000,501,537,0,2038
22:51:27,5,999,546,537,0,2082
22:51:28,5,999,967,537,0,2503
22:51:29,5,999,485,537,0,2021
22:51:30,5,999,467,537,0,2003
22:51:31,5,1000,510,537,0,2047
22:51:32,5,1000,525,537,0,2062
22:51:33,5,1000,427,536,0,1963
22:51:34,5,999,725,537,0,2261
22:51:35,5,1000,553,536,0,2089
22:51:36,5,999,518,536,0,2053
22:51:37,5,1000,491,537,0,2028
22:51:38,5,1000,443,537,103,2083
22:51:39,5,1001,489,537,189,2216
22:51:40,5,1001,492,537,115,2145
22:51:41,5,1002,476,537,422,2437
22:51:42,5,1001,482,537,518,2538
22:51:43,5,1002,486,537,650,2675
22:51:44,5,1001,505,537,590,2633
22:51:45,5,1001,555,537,514,2607
22:51:46,5,0,0,0,0,0
22:51:47,5,1001,502,536,550,2589
22:51:48,5,0,0,0,0,0
22:51:49,5,1001,499,536,583,2619
22:51:50,5,1001,502,537,494,2534
22:51:51,5,1001,481,536,536,2554
22:51:52,5,1001,490,536,494,2521
22:51:53,5,1002,501,536,545,2584
22:51:54,5,1002,484,538,351,2375
22:51:55,5,1001,488,539,622,2650
22:51:56,5,1002,862,541,536,2941
22:51:57,5,1005,485,550,733,2773
22:51:58,5,1002,470,562,486,2520
22:51:59,5,1003,420,564,460,2447
22:52:00,5,1003,499,567,324,2393
22:52:01,5,1003,491,570,609,2673
22:52:02,5,1003,493,573,403,2472
22:52:03,5,1003,472,578,703,2756
22:52:04,5,1003,459,582,566,2610
22:52:05,5,1003,492,586,499,2580
22:52:06,5,0,0,0,0,0
22:52:07,5,1002,484,591,454,2531
22:52:08,5,1002,481,591,624,2698
22:52:09,5,1002,516,592,455,2565
22:52:10,5,0,0,0,0,0
22:52:11,5,1001,474,592,467,2534
22:52:12,5,1002,490,594,633,2719
22:52:13,5,1002,498,595,560,2655
22:52:14,5,1002,503,597,562,2664
22:52:15,5,1002,472,599,453,2526
22:52:16,5,1002,506,600,616,2724
22:52:17,5,1001,480,601,668,2750
22:52:18,5,0,0,0,0,0
22:52:19,5,1002,511,602,449,2564
22:52:20,5,1001,513,601,448,2563
22:52:21,5,1001,449,600,521,2571
22:52:22,5,1001,494,599,371,2465
22:52:23,5,1002,479,599,598,2678
22:52:24,5,1002,570,598,440,2610
22:52:25,5,1002,520,598,715,2835
22:52:26,5,1002,484,597,540,2623
22:52:27,5,1001,849,596,306,2752
22:52:28,5,1002,492,597,375,2466
22:52:29,5,1001,493,597,594,2685
22:52:30,5,1002,521,599,460,2582
22:52:31,5,1002,500,600,262,2364
22:52:32,5,1001,512,599,319,2431
22:52:33,5,0,0,0,0,0
22:52:34,5,1002,497,598,876,2973
22:52:35,5,1001,485,598,883,2967
22:52:36,5,1001,505,598,898,3002
22:52:37,5,1002,475,597,890,2964
22:52:38,5,1001,454,598,932,2985
22:52:39,5,1001,497,597,830,2925
22:52:40,5,1001,532,596,880,3009
22:52:41,5,1002,488,596,804,2890
22:52:42,5,1002,571,596,858,3027
22:52:43,5,1002,475,596,959,3032
22:52:44,5,1001,448,595,852,2896
22:52:45,5,1001,431,594,770,2796
22:52:46,5,1001,484,594,786,2865
22:52:47,5,1001,492,593,952,3038
22:52:48,5,1001,490,593,813,2897
22:52:49,5,1001,518,592,881,2992
22:52:50,5,1002,497,593,950,3042
22:52:51,5,1002,497,593,940,3032
22:52:52,5,1002,499,592,843,2936
22:52:53,5,1001,501,592,865,2959
22:52:54,5,1001,461,592,794,2848
22:52:55,5,1001,531,591,872,2995
22:52:56,5,1001,559,590,826,2976
22:52:57,5,1001,488,589,934,3012
22:52:58,5,1001,481,590,820,2892
22:52:59,5,1001,505,589,833,2928
22:53:00,5,1001,476,589,889,2955
22:53:01,5,1001,489,590,762,2842
22:53:02,5,1001,510,588,806,2905
22:53:03,5,1002,497,590,982,3071
22:53:04,5,1001,497,591,796,2885
22:53:05,5,1001,488,592,973,3054
22:53:06,5,1002,530,592,889,3013
22:53:07,5,1001,502,591,832,2926
22:53:08,5,1001,523,591,815,2930
22:53:09,5,1002,494,594,820,2910
22:53:10,5,1002,478,594,933,3007
22:53:11,5,1002,507,598,886,2993
22:53:12,5,1002,492,602,951,3047
22:53:13,5,1002,484,603,849,2938
22:53:14,5,1002,498,604,757,2861
22:53:15,5,1002,516,605,903,3026
22:53:16,5,1002,506,606,860,2974
22:53:17,5,1002,511,606,897,3016
22:53:18,5,1001,497,607,849,2954
22:53:19,5,1002,493,607,834,2936
22:53:20,5,1001,500,607,812,2920
22:53:21,5,1001,499,607,890,2997
22:53:22,5,1002,484,608,786,2880
22:53:23,5,1002,498,609,815,2924
22:53:24,5,1002,496,609,904,3011
22:53:25,5,1001,494,609,861,2965
22:53:26,5,1001,492,609,793,2895
22:53:27,5,1001,511,609,841,2962
22:53:28,5,1001,492,609,888,2990
22:53:29,5,1001,498,609,830,2938
22:53:30,5,1001,474,610,964,3049
22:53:31,5,1001,489,610,892,2992
22:53:32,5,1001,493,609,869,2972
22:53:33,5,1001,494,608,890,2993
22:53:34,5,1001,481,608,873,2963
22:53:35,5,1001,501,608,928,3038
22:53:36,5,1002,500,609,899,3010
22:53:37,5,1002,503,612,841,2958
22:53:38,5,1002,501,616,884,3003
22:53:39,5,1001,475,616,924,3016
22:53:40,5,1002,512,616,927,3057
22:53:41,5,1001,494,615,806,2916
22:53:42,5,1001,498,614,890,3003
22:53:43,5,1002,485,614,906,3007
22:53:44,5,1001,503,614,809,2927
22:53:45,5,1001,496,613,848,2958
22:53:46,5,1002,490,612,899,3003
22:53:47,5,1001,483,612,930,3026
22:53:48,5,1001,497,611,778,2887
22:53:49,5,1001,484,611,961,3057
22:53:50,5,1001,489,610,897,2997
22:53:51,5,1001,487,610,802,2900
22:53:52,5,0,0,0,0,0
22:53:53,5,1001,498,609,921,3029
22:53:54,5,1001,502,608,887,2998
22:53:55,5,1001,503,607,843,2954
22:53:56,5,1001,487,606,844,2938
22:53:57,5,1001,493,606,924,3024
22:53:58,5,1001,495,606,908,3010
22:53:59,5,1001,492,605,819,2917
22:54:00,5,1001,489,604,892,2986
22:54:01,5,1001,484,604,916,3005
22:54:02,5,1001,479,603,909,2992
22:54:03,5,1001,478,602,824,2905
22:54:04,5,1001,492,602,947,3042
22:54:05,5,1002,493,601,893,2989
22:54:06,5,1001,485,600,948,3034
22:54:07,5,1002,489,600,950,3041
22:54:08,5,1001,493,599,883,2976
22:54:09,5,1001,501,599,822,2923
22:54:10,5,1001,499,598,879,2977
22:54:11,5,1001,498,598,821,2918
22:54:12,5,1001,489,598,849,2937
22:54:13,5,1001,493,597,976,3067
22:54:14,5,1002,511,598,772,2883
22:54:15,5,1002,484,598,835,2919
22:54:16,5,1002,491,600,917,3010
22:54:17,5,1001,493,601,878,2973
22:54:18,5,1001,486,602,945,3034
22:54:19,5,1002,487,603,874,2966
22:54:20,5,1002,506,605,960,3073
22:54:21,5,1001,490,604,870,2965
22:54:22,5,1002,496,606,776,2880
22:54:23,5,1001,502,606,809,2918
22:54:24,5,1002,498,607,779,2886
22:54:25,5,1002,499,608,873,2982
22:54:26,5,1001,494,609,909,3013
22:54:27,5,1002,497,609,845,2953
22:54:28,5,1002,481,607,850,2940
22:54:29,5,1002,495,607,780,2884
22:54:30,5,1001,499,607,889,2996
22:54:31,5,1001,497,607,890,2995
22:54:32,5,1001,501,606,793,2901
22:54:33,5,1001,485,605,977,3068
22:54:34,5,1002,483,605,852,2942
22:54:35,5,1001,486,604,931,3022
22:54:36,5,1001,484,604,827,2916
22:54:37,5,1001,495,604,963,3063
22:54:38,5,1001,491,603,871,2966
22:54:39,5,1001,497,602,828,2928
22:54:40,5,1002,491,602,878,2973
22:54:41,5,1001,490,602,823,2916
22:54:42,5,1001,508,602,862,2973
22:54:43,5,1001,503,601,833,2938
22:54:44,5,1001,494,601,794,2890
22:54:45,5,1001,503,602,901,3007
22:54:46,5,1001,501,600,853,2955
22:54:47,5,1001,494,600,925,3020
22:54:48,5,1001,513,600,939,3053
22:54:49,5,1001,480,599,831,2911
22:54:50,5,1001,481,598,855,2935
22:54:51,5,1001,490,598,881,2970
22:54:52,5,1001,503,598,888,2990
22:54:53,5,1001,507,598,850,2956
22:54:54,5,1002,505,598,801,2906
22:54:55,5,1001,506,598,935,3040
22:54:56,5,1001,497,596,865,2959
22:54:57,5,1001,492,596,904,2993
22:54:58,5,1000,499,596,834,2929
22:54:59,5,1000,479,597,850,2926
22:55:00,5,1000,489,596,785,2870
22:55:01,5,1002,495,596,954,3047
22:55:02,5,1001,497,596,974,3068
22:55:03,5,1001,482,595,832,2910
22:55:04,5,1001,480,596,899,2976
22:55:05,5,1002,487,596,918,3003
22:55:06,5,1001,507,596,847,2951
22:55:07,5,1002,490,596,835,2923
22:55:08,5,1001,489,595,906,2991
22:55:09,5,1002,476,595,973,3046
22:55:10,5,1001,483,594,890,2968
22:55:11,5,1002,507,594,879,2982
22:55:12,5,1002,484,593,850,2929
22:55:13,5,1001,475,594,878,2948
22:55:14,5,1002,501,594,813,2910
22:55:15,5,1002,486,594,868,2950
22:55:16,5,1002,501,594,812,2909
22:55:17,5,1001,498,593,845,2937
22:55:18,5,1002,490,593,779,2864
22:55:19,5,1002,476,593,934,3005
22:55:20,5,1002,481,593,912,2988
22:55:21,5,1002,487,594,912,2995
22:55:22,5,1002,494,596,963,3055
22:55:23,5,1003,478,596,803,2880
22:55:24,5,1002,502,597,843,2944
22:55:25,5,1001,480,596,843,2920
22:55:26,5,1002,499,596,912,3009
22:55:27,5,1002,461,596,793,2852
22:55:28,5,1002,500,595,952,3049
22:55:29,5,1001,488,595,823,2907
22:55:30,5,1002,509,594,939,3044
22:55:31,5,0,0,0,0,0
22:55:32,5,1001,510,593,851,2955
22:55:33,5,1001,489,593,895,2978
22:55:34,5,1002,512,592,929,3035
22:55:35,5,1001,500,591,857,2949
22:55:36,5,1001,498,591,780,2870
22:55:37,5,1001,494,590,874,2959
22:55:38,5,1001,548,590,794,2933
22:55:39,5,1001,495,590,906,2992
22:55:40,5,1002,500,590,808,2900
22:55:41,5,1001,499,589,826,2915
22:55:42,5,1001,493,589,893,2976
22:55:43,5,1002,480,588,858,2928
22:55:44,5,1001,481,588,928,2998
22:55:45,5,1002,497,588,899,2986
22:55:46,5,1002,495,587,940,3024
22:55:47,5,1002,484,587,950,3023
22:55:48,5,1001,502,586,841,2930
22:55:49,5,1002,499,586,923,3010
22:55:50,5,1001,497,585,875,2958
22:55:51,5,1002,520,585,766,2873
22:55:52,5,1002,487,584,822,2895
22:55:53,5,1002,492,583,897,2974
22:55:54,5,1002,483,583,862,2930
22:55:55,5,1002,501,582,857,2942
22:55:56,5,1002,501,582,940,3025
22:55:57,5,1002,504,582,860,2948
22:55:58,5,1002,500,582,888,2972
22:55:59,5,1001,492,581,810,2884
22:56:00,5,1002,488,582,911,2983
22:56:01,5,1002,488,581,943,3014
22:56:02,5,1001,493,581,862,2937
22:56:03,5,1002,492,580,839,2913
22:56:04,5,1002,492,581,825,2900
22:56:05,5,1001,500,580,751,2832
22:56:06,5,1002,494,580,897,2973
22:56:07,5,1001,494,580,874,2949
22:56:08,5,1001,491,579,800,2871
22:56:09,5,1002,500,579,853,2934
22:56:10,5,1001,495,579,853,2928
22:56:11,5,1000,488,578,827,2893
22:56:12,5,999,511,578,769,2857
22:56:13,5,1000,498,578,855,2931
22:56:14,5,1002,491,578,797,2868
22:56:15,5,1001,505,577,900,2983
22:56:16,5,1001,489,577,801,2868
22:56:17,5,1001,493,577,863,2934
22:56:18,5,1001,503,577,543,2624
22:56:19,5,1001,488,577,581,2647
22:56:20,5,1000,494,578,734,2806
22:56:21,5,1001,488,578,614,2681
22:56:22,5,1001,499,578,468,2546
22:56:23,5,1001,485,579,402,2467
22:56:24,5,1000,500,579,451,2530
22:56:25,5,1000,491,580,323,2394
22:56:26,5,1001,492,580,441,2514
22:56:27,5,1001,496,581,270,2348
22:56:28,5,1001,499,582,452,2534
22:56:29,5,1001,494,582,602,2679
22:56:30,5,1001,496,583,578,2658
22:56:31,5,1001,489,583,472,2545
22:56:32,5,1001,488,584,681,2754
22:56:33,5,1001,494,583,639,2717
22:56:34,5,1001,501,583,351,2436
22:56:35,5,1001,494,583,541,2619
22:56:36,5,1001,482,583,350,2416
22:56:37,5,1001,491,584,521,2597
22:56:38,5,1001,494,583,425,2503
22:56:39,5,1001,492,583,636,2712
22:56:40,5,1001,493,584,785,2863
22:56:41,5,1002,492,583,572,2649
22:56:42,5,1002,489,583,519,2593
22:56:43,5,1001,483,583,509,2576
22:56:44,5,1001,479,583,455,2518
22:56:45,5,1001,491,583,485,2560
22:56:46,5,1002,497,584,645,2728
22:56:47,5,1001,495,584,640,2720
22:56:48,5,1001,490,585,428,2504
22:56:49,5,1001,500,587,507,2595
22:56:50,5,1001,491,587,479,2558
22:56:51,5,1001,496,587,455,2539
22:56:52,5,1001,488,588,391,2468
22:56:53,5,1001,496,588,515,2600
22:56:54,5,1001,493,588,480,2562
22:56:55,5,1001,491,588,566,2646
22:56:56,5,1001,494,588,543,2626
22:56:57,5,1001,488,588,444,2521
22:56:58,5,1001,507,588,789,2885
22:56:59,5,1001,505,588,919,3013
22:57:00,5,1001,492,588,910,2991
22:57:01,5,1001,504,588,907,3000
22:57:02,5,1001,480,588,887,2956
22:57:03,5,1002,500,588,838,2928
22:57:04,5,1001,495,588,941,3025
22:57:05,5,1002,509,589,863,2963
22:57:06,5,1001,492,588,847,2928
22:57:07,5,1001,491,588,891,2971
22:57:08,5,1001,524,588,909,3022
22:57:09,5,1001,488,587,918,2994
22:57:10,5,1001,499,587,909,2996
22:57:11,5,1001,501,586,951,3039
22:57:12,5,1002,496,586,848,2932
22:57:13,5,1001,498,586,906,2991
22:57:14,5,1001,506,586,802,2895
22:57:15,5,1001,483,585,904,2973
22:57:16,5,1001,502,584,918,3005
22:57:17,5,1001,460,583,868,2912
22:57:18,5,1001,486,583,994,3064
22:57:19,5,1001,491,581,883,2956
22:57:20,5,1001,500,581,451,2533
22:57:21,5,1002,512,581,472,2567
22:57:22,5,1001,495,580,479,2555
22:57:23,5,1001,480,580,426,2487
22:57:24,5,1001,472,579,284,2336
22:57:25,5,1001,495,578,418,2492
22:57:26,5,1001,492,578,587,2658
22:57:27,5,1000,478,577,466,2521
22:57:28,5,1000,506,577,649,2732
22:57:29,5,1001,488,576,309,2374
22:57:30,5,1002,485,576,293,2356
22:57:31,5,1001,494,576,431,2502
22:57:32,5,1001,481,576,475,2533
22:57:33,5,1001,494,575,466,2536
22:57:34,5,1002,494,575,592,2663
22:57:35,5,1001,504,575,473,2553
22:57:36,5,1001,497,575,329,2402
22:57:37,5,1001,499,575,414,2489
22:57:38,5,1001,485,576,589,2651
22:57:39,5,1001,471,576,435,2483
22:57:40,5,1001,410,576,498,2485
22:57:41,5,1001,495,575,538,2609
22:57:42,5,1001,500,576,438,2515
22:57:43,5,1000,491,581,576,2648
22:57:44,5,1001,505,584,375,2465
22:57:45,5,1001,488,583,657,2729
22:57:46,5,1001,491,582,422,2496
22:57:47,5,1000,518,581,511,2610
22:57:48,5,1000,461,580,590,2631
22:57:49,5,1001,483,580,340,2404
22:57:50,5,1001,492,580,726,2799
22:57:51,5,1001,485,579,503,2568
22:57:52,5,1001,494,578,603,2676
22:57:53,5,1000,493,578,416,2487
22:57:54,5,1001,497,577,445,2520
22:57:55,5,1001,503,577,750,2831
22:57:56,5,1000,488,577,576,2641
22:57:57,5,1000,495,576,415,2486
22:57:58,5,1000,486,576,679,2741
22:57:59,5,1000,522,575,483,2580
22:58:00,5,1000,558,575,379,2512
22:58:01,5,1000,556,575,682,2813
22:58:02,5,1000,485,574,950,3009
22:58:03,5,1000,494,574,891,2959
22:58:04,5,1001,454,574,918,2947
22:58:05,5,1000,485,573,876,2934
22:58:06,5,1000,490,573,888,2951
22:58:07,5,1001,507,573,958,3039
22:58:08,5,1000,492,573,914,2979
22:58:09,5,1001,491,572,866,2930
22:58:10,5,1001,491,572,843,2907
22:58:11,5,1001,490,572,966,3029
22:58:12,5,1001,496,572,941,3010
22:58:13,5,1001,492,572,877,2942
22:58:14,5,1001,477,572,874,2924
22:58:15,5,1000,485,573,957,3015
22:58:16,5,1000,482,573,910,2965
22:58:17,5,1000,495,573,853,2921
22:58:18,5,1000,500,573,822,2895
22:58:19,5,1000,495,573,899,2967
22:58:20,5,1000,500,574,894,2968
22:58:21,5,1001,498,574,862,2935
22:58:22,5,1001,486,573,923,2983
22:58:23,5,1001,483,574,903,2961
22:58:24,5,1001,497,573,822,2893
22:58:25,5,1001,497,573,983,3054
22:58:26,5,1001,490,573,871,2935
22:58:27,5,1001,498,572,901,2972
22:58:28,5,1001,490,572,851,2914
22:58:29,5,1001,486,572,875,2934
22:58:30,5,1001,485,572,847,2905
22:58:31,5,1001,496,572,842,2911
22:58:32,5,1001,493,571,954,3019
22:58:33,5,1001,498,572,948,3019
22:58:34,5,1001,480,572,988,3041
22:58:35,5,1001,483,571,613,2668
22:58:36,5,1001,507,571,446,2525
22:58:37,5,1001,492,571,635,2699
22:58:38,5,1000,486,570,461,2517
22:58:39,5,1001,495,570,310,2376
22:58:40,5,1001,492,569,506,2568
22:58:41,5,1001,497,570,580,2648
22:58:42,5,1001,492,569,585,2647
22:58:43,5,1001,515,569,520,2605
22:58:44,5,1001,486,569,268,2324
22:58:45,5,1001,505,568,478,2552
22:58:46,5,1001,486,568,335,2390
22:58:47,5,1002,492,568,589,2651
22:58:48,5,1001,499,567,563,2630
22:58:49,5,1001,494,567,373,2435
22:58:50,5,1001,499,566,700,2766
22:58:51,5,1002,481,566,726,2775
22:58:52,5,1001,492,566,773,2832
22:58:53,5,1001,489,566,963,3019
22:58:54,5,1001,499,568,920,2988
22:58:55,5,1000,488,569,830,2887
22:58:56,5,1001,492,570,832,2895
22:58:57,5,1001,500,572,942,3015
22:58:58,5,1000,495,573,840,2908
22:58:59,5,1001,497,577,873,2948
22:59:00,5,1000,486,581,908,2975
22:59:01,5,999,492,583,898,2972
22:59:02,5,1000,510,584,847,2941
22:59:03,5,1000,493,583,907,2983
22:59:04,5,1000,490,582,865,2937
22:59:05,5,1001,507,582,813,2903
22:59:06,5,1000,501,581,837,2919
22:59:07,5,1000,499,580,890,2969
22:59:08,5,1000,359,579,851,2789
22:59:09,5,1000,489,578,971,3038
22:59:10,5,1001,491,578,854,2924
22:59:11,5,1001,496,578,819,2894
22:59:12,5,1001,498,576,912,2987
22:59:13,5,1001,498,576,887,2962
22:59:14,5,1000,501,576,890,2967
22:59:15,5,1001,501,575,923,3000
22:59:16,5,1001,497,574,919,2991
22:59:17,5,1001,497,573,929,3000
22:59:18,5,1001,507,573,919,3000
22:59:19,5,1001,492,573,815,2881
22:59:20,5,1000,495,572,889,2956
22:59:21,5,1000,496,572,949,3017
22:59:22,5,1001,494,572,938,3005
22:59:23,5,1001,492,571,870,2934
22:59:24,5,1001,489,571,869,2930
22:59:25,5,1001,496,571,836,2904
22:59:26,5,1000,496,571,894,2961
22:59:27,5,1000,500,571,934,3005
22:59:28,5,1000,502,570,975,3047
22:59:29,5,1001,475,570,821,2867
22:59:30,5,998,498,569,930,2995
22:59:31,5,999,453,569,872,2893
22:59:32,5,999,510,569,906,2984
22:59:33,5,1001,495,568,968,3032
22:59:34,5,1001,507,567,930,3005
22:59:35,5,1001,416,567,971,2955
22:59:36,5,1000,516,567,898,2981
22:59:37,5,999,546,566,952,3063
22:59:38,5,1000,499,566,881,2946
22:59:39,5,1005,520,566,884,2975
22:59:40,5,1004,492,565,885,2946
22:59:41,5,1002,488,564,887,2941
22:59:42,5,999,488,565,922,2974
22:59:43,5,1002,519,564,886,2971
22:59:44,5,1002,493,564,945,3004
22:59:45,5,999,499,564,968,3030
22:59:46,5,999,444,564,913,2920
22:59:47,5,999,452,564,890,2905
22:59:48,5,999,496,563,864,2922
22:59:49,5,999,507,563,907,2976
22:59:50,5,1000,479,564,822,2865
22:59:51,5,1001,497,563,909,2970
22:59:52,5,1001,509,563,847,2920
22:59:53,5,1000,532,563,860,2955
22:59:54,5,1000,494,563,858,2915
22:59:55,5,1005,491,563,859,2918
22:59:56,5,1005,483,563,913,2964
22:59:57,5,0,0,0,0,0
22:59:58,5,1001,491,562,941,2995
22:59:59,5,1001,500,562,898,2961
23:00:00,5,1001,504,562,990,3057
23:00:01,5,1001,487,562,924,2974
23:00:02,5,1001,493,562,940,2996
23:00:03,5,1001,491,562,876,2930
23:00:04,5,1001,494,562,905,2962
23:00:05,5,1001,511,561,885,2958
23:00:06,5,1001,490,562,889,2942
23:00:07,5,1001,491,562,886,2940
23:00:08,5,1001,492,561,869,2923
23:00:09,5,1000,493,561,899,2953
23:00:10,5,1001,485,562,973,3021
23:00:11,5,1001,481,562,929,2973
23:00:12,5,1001,475,562,952,2990
23:00:13,5,1001,496,562,843,2902
23:00:14,5,1001,499,563,876,2939
23:00:15,5,1001,502,564,948,3015
23:00:16,5,1001,498,563,953,3015
23:00:17,5,1001,503,563,836,2903
23:00:18,5,1001,505,563,860,2929
23:00:19,5,1001,502,563,918,2984
23:00:20,5,1001,511,563,999,3074
23:00:21,5,1001,488,563,969,3021
23:00:22,5,1001,494,564,829,2888
23:00:23,5,1001,506,564,869,2940
23:00:24,5,1000,489,565,885,2939
23:00:25,5,1001,508,565,914,2988
23:00:26,5,1001,508,565,963,3037
23:00:27,5,1000,487,564,908,2959
23:00:28,5,1001,505,565,939,3010
23:00:29,5,1000,497,565,961,3023
23:00:30,5,1001,485,565,844,2895
23:00:31,5,1001,495,565,849,2910
23:00:32,5,1001,483,565,818,2867
23:00:33,5,1001,518,564,975,3058
23:00:34,5,1001,491,564,843,2899
23:00:35,5,1001,499,563,947,3010
23:00:36,5,1001,502,563,957,3023
23:00:37,5,1000,494,562,923,2979
23:00:38,5,1001,506,562,915,2984
23:00:39,5,1001,500,562,981,3044
23:00:40,5,1001,487,562,927,2977
23:00:41,5,1001,479,562,979,3021
23:00:42,5,1002,491,562,956,3011
23:00:43,5,1001,493,562,952,3008
23:00:44,5,1001,500,562,925,2988
23:00:45,5,0,0,0,0,0
23:00:46,5,1001,496,562,978,3037
23:00:47,5,1001,486,561,937,2985
23:00:48,5,1000,492,561,940,2993
23:00:49,5,1001,504,560,964,3029
23:00:50,5,1001,500,560,912,2973
23:00:51,5,1001,472,560,945,2978
23:00:52,5,1001,488,560,918,2967
23:00:53,5,1000,506,559,920,2985
23:00:54,5,1001,502,559,979,3041
23:00:55,5,1001,499,558,964,3022
23:00:56,5,1001,509,558,980,3048
23:00:57,5,1001,493,559,936,2989
23:00:58,5,1001,484,559,114,2158
23:00:59,5,1001,475,559,145,2180
23:01:00,5,1001,472,558,153,2184
23:01:01,5,1001,491,559,88,2139
23:01:02,5,1001,482,559,113,2155
23:01:03,5,1001,482,558,87,2128
23:01:04,5,1000,481,558,164,2203
23:01:05,5,1000,504,557,135,2196
23:01:06,5,1001,499,558,179,2237
23:01:07,5,1001,501,558,232,2292
23:01:08,5,1001,516,557,215,2289
23:01:09,5,1001,474,556,91,2122
23:01:10,5,1000,482,556,86,2124
23:01:11,5,1000,511,557,59,2127
23:01:12,5,1001,465,557,112,2135
23:01:13,5,1001,482,557,47,2087
23:01:14,5,1001,492,556,250,2299
23:01:15,5,1001,504,556,106,2167
23:01:16,5,1001,478,556,167,2202
23:01:17,5,1001,517,556,155,2229
23:01:18,5,1001,493,556,80,2130
23:01:19,5,1001,482,555,3,2041
23:01:20,5,1001,498,555,4,2058
23:01:21,5,1001,495,555,1,2052
23:01:22,5,1001,509,555,3,2068
23:01:23,5,1001,500,555,4,2060
23:01:24,5,1001,496,555,5,2057
23:01:25,5,1001,504,553,0,2058
23:01:26,5,1001,489,553,2,2045
23:01:27,5,1001,502,554,1,2058
23:01:28,5,1001,461,554,5,2021
23:01:29,5,1000,497,553,4,2054
23:01:30,5,1001,504,553,2,2060
23:01:31,5,1001,485,553,0,2039
23:01:32,5,1001,492,553,3,2049
23:01:33,5,1001,502,553,4,2060
23:01:34,5,1001,487,552,3,2043
23:01:35,5,1001,486,552,3,2042
23:01:36,5,1000,498,552,4,2054
23:01:37,5,1001,486,552,3,2042
23:01:38,5,1000,496,551,3,2050
23:01:39,5,1001,482,551,3,2037
23:01:40,5,1001,503,551,1,2056
23:01:41,5,1001,487,551,2,2041
23:01:42,5,1001,484,551,0,2036
23:01:43,5,1001,495,551,0,2047
23:01:44,5,1001,485,551,4,2041
23:01:45,5,1001,503,551,1,2056
23:01:46,5,1000,499,551,2,2052
23:01:47,5,0,0,0,0,0
23:01:48,5,1001,517,551,3,2072
23:01:49,5,1001,478,551,4,2034
23:01:50,5,1000,487,551,1,2039
23:01:51,5,1001,503,551,2,2057
23:01:52,5,1001,493,551,1,2046
23:01:53,5,1001,498,550,1,2050
23:01:54,5,1001,484,550,0,2035
23:01:55,5,1001,508,550,2,2061
23:01:56,5,1001,482,550,1,2034
23:01:57,5,1000,491,550,1,2042
23:01:58,5,1001,493,550,0,2044
23:01:59,5,1000,490,549,0,2039
23:02:00,5,1001,504,549,0,2054
23:02:01,5,1001,462,549,0,2012
23:02:02,5,1001,489,549,0,2039
23:02:03,5,1000,473,549,1,2023
23:02:04,5,1001,499,548,1,2049
23:02:05,5,0,0,0,0,0
23:02:06,5,1001,524,548,1,2074
23:02:07,5,1001,446,548,1,1996
23:02:08,5,1001,490,548,0,2039
23:02:09,5,1001,527,548,2,2078
23:02:10,5,1001,503,548,1,2053
23:02:11,5,1001,510,547,2,2060
23:02:12,5,1000,510,547,1,2058
23:02:13,5,1000,444,547,1,1992
23:02:14,5,1001,482,546,0,2029
23:02:15,5,1001,498,546,2,2047
23:02:16,5,1001,512,546,1,2060
23:02:17,5,1001,491,546,0,2038
23:02:18,5,1001,488,546,2,2037
23:02:19,5,1001,489,545,1,2036
23:02:20,5,1001,498,544,1,2044
23:02:21,5,1001,482,542,1,2026
23:02:22,5,1000,488,546,0,2034
23:02:23,5,1001,494,541,0,2036
23:02:24,5,1001,488,542,0,2031
23:02:25,5,1001,487,541,0,2029
23:02:26,5,1000,471,541,0,2012
23:02:27,5,1001,471,541,1,2014
23:02:28,5,1001,501,543,0,2045
23:02:29,5,1000,499,540,0,2039
23:02:30,5,1001,492,545,1,2039
23:02:31,5,1001,501,543,1,2046
23:02:32,5,1001,501,547,1,2050
23:02:33,5,1001,500,551,1,2053
23:02:34,5,1001,499,548,2,2050
23:02:35,5,1001,492,537,1,2031
23:02:36,5,1001,487,543,1,2032
23:02:37,5,1001,494,537,2,2034
23:02:38,5,1001,494,541,0,2036
23:02:39,5,1002,498,542,1,2043
23:02:40,5,1001,495,544,1,2041
23:02:41,5,1002,487,545,2,2036
23:02:42,5,1001,502,536,0,2039
23:02:43,5,1001,500,540,2,2043
23:02:44,5,1001,499,536,0,2036
23:02:45,5,1001,482,536,1,2020
23:02:46,5,1002,484,537,1,2024
23:02:47,5,1001,496,539,1,2037
23:02:48,5,1001,499,541,1,2042
23:02:49,5,1002,489,542,0,2033
23:02:50,5,1001,502,534,1,2038
23:02:51,5,1001,492,537,0,2030
23:02:52,5,1001,482,535,0,2018
23:02:53,5,1000,515,540,1,2056
23:02:54,5,1001,874,535,1,2411
23:02:55,5,1000,492,535,0,2027
23:02:56,5,1000,496,551,1,2048
23:02:57,5,1001,498,537,1,2037
23:02:58,5,1001,503,537,1,2042
23:02:59,5,1001,501,557,2,2061
23:03:00,5,0,0,0,0,0
23:03:01,5,1001,485,544,1,2031
23:03:02,5,1001,492,535,2,2030
23:03:03,5,1001,501,536,0,2038
23:03:04,5,1003,485,536,0,2024
23:03:05,5,1002,495,535,1,2033
23:03:06,5,1003,484,540,0,2027
23:03:07,5,1003,452,535,1,1991
23:03:08,5,1003,495,535,2,2035
23:03:09,5,1002,471,539,1,2013
23:03:10,5,1003,487,550,1,2041
23:03:11,5,1003,500,546,1,2050
23:03:12,5,1003,492,538,0,2033
23:03:13,5,1002,485,541,0,2028
23:03:14,5,1001,499,548,0,2048
23:03:15,5,1002,488,540,2,2032
23:03:16,5,1002,492,536,2,2032
23:03:17,5,1001,488,540,1,2030
23:03:18,5,1002,496,553,0,2051
23:03:19,5,1003,502,536,0,2041
23:03:20,5,1003,496,547,0,2046
23:03:21,5,1003,497,543,0,2043
23:03:22,5,1003,533,544,0,2080
23:03:23,5,1003,492,538,1,2034
23:03:24,5,1003,489,538,1,2031
23:03:25,5,1003,504,539,2,2048
23:03:26,5,1003,498,540,0,2041
23:03:27,5,1004,499,545,0,2048
23:03:28,5,1004,495,537,0,2036
23:03:29,5,1004,492,538,1,2035
23:03:30,5,1004,492,540,1,2037
23:03:31,5,1003,486,538,1,2028
23:03:32,5,1004,495,540,0,2039
23:03:33,5,1004,491,540,2,2037
23:03:34,5,1004,476,540,1,2021
23:03:35,5,1004,496,541,1,2042
23:03:36,5,1004,501,541,0,2046
23:03:37,5,1004,490,541,0,2035
23:03:38,5,1004,495,541,1,2041
23:03:39,5,1004,491,541,1,2037
23:03:40,5,1004,495,541,0,2040
23:03:41,5,1004,488,540,1,2033
23:03:42,5,1004,488,541,1,2034
23:03:43,5,1004,517,541,1,2063
23:03:44,5,1004,507,541,2,2054
23:03:45,5,1004,446,541,0,1991
23:03:46,5,1004,488,541,2,2035
23:03:47,5,1004,495,541,1,2041
23:03:48,5,1004,502,541,2,2049
23:03:49,5,1004,495,541,1,2041
23:03:50,5,1004,488,541,0,2033
23:03:51,5,1004,486,541,0,2031
23:03:52,5,1004,494,541,1,2040
23:03:53,5,1004,494,541,0,2039
23:03:54,5,1002,499,541,2,2044
23:03:55,5,1004,501,541,1,2047
23:03:56,5,1003,497,542,1,2043
23:03:57,5,1001,490,541,0,2032
23:03:58,5,1002,492,542,2,2038
23:03:59,5,1004,495,541,2,2042
23:04:00,5,1005,491,541,0,2037
23:04:01,5,1005,498,542,0,2045
23:04:02,5,0,0,0,0,0
23:04:03,5,1004,505,541,1,2051
23:04:04,5,1004,499,541,1,2045
23:04:05,5,1004,505,541,1,2051
23:04:06,5,1004,492,541,0,2037
23:04:07,5,1006,562,541,1,2110
23:04:08,5,1005,495,541,1,2042
23:04:09,5,1003,494,541,0,2038
23:04:10,5,1006,499,541,0,2046
23:04:11,5,1005,490,541,0,2036
23:04:12,5,1004,503,541,0,2048
23:04:13,5,1005,501,541,0,2047
23:04:14,5,1005,490,541,1,2037
23:04:15,5,1005,497,541,1,2044
23:04:16,5,1005,498,541,0,2044
23:04:17,5,1004,489,541,1,2035
23:04:18,5,1004,492,540,1,2037
23:04:19,5,1004,498,540,1,2043
23:04:20,5,1006,489,541,2,2038
23:04:21,5,1004,491,540,0,2035
23:04:22,5,1003,494,541,0,2038
23:04:23,5,1004,496,540,2,2042
23:04:24,5,1003,487,540,0,2030
23:04:25,5,1005,487,541,1,2034
23:04:26,5,1005,498,540,1,2044
23:04:27,5,1005,490,541,2,2038
23:04:28,5,1005,503,540,1,2049
23:04:29,5,1005,493,540,1,2039
23:04:30,5,1004,501,540,1,2046
23:04:31,5,1004,493,541,0,2038
23:04:32,5,1004,499,541,2,2046
23:04:33,5,1004,491,540,1,2036
23:04:34,5,1004,492,540,2,2038
23:04:35,5,1004,509,541,1,2055
23:04:36,5,1005,488,541,1,2035
23:04:37,5,1004,486,540,1,2031
23:04:38,5,1004,496,540,1,2041
23:04:39,5,1004,493,540,1,2038
23:04:40,5,1004,485,540,0,2029
23:04:41,5,1003,491,540,1,2035
23:04:42,5,1003,494,540,1,2038
23:04:43,5,1004,499,540,2,2045
23:04:44,5,1004,493,540,0,2037
23:04:45,5,1004,489,540,0,2033
23:04:46,5,1004,496,540,2,2042
23:04:47,5,1004,506,539,1,2050
23:04:48,5,1003,502,540,0,2045
23:04:49,5,1003,505,540,0,2048
23:04:50,5,1003,491,540,2,2036
23:04:51,5,1004,488,540,0,2032
23:04:52,5,1004,499,540,1,2044
23:04:53,5,1003,495,540,0,2038
23:04:54,5,1004,499,540,1,2044
23:04:55,5,1004,489,540,1,2034
23:04:56,5,1004,481,540,2,2027
23:04:57,5,1004,493,540,2,2039
23:04:58,5,1004,491,540,0,2035
23:04:59,5,1004,492,540,2,2038
23:05:00,5,1004,471,540,1,2016
23:05:01,5,0,0,0,0,0
23:05:02,5,1004,484,541,1,2030
23:05:03,5,1005,498,540,1,2044
23:05:04,5,1004,493,541,2,2040
23:05:05,5,1004,491,541,0,2036
23:05:06,5,1005,488,540,1,2034
23:05:07,5,1004,498,540,1,2043
23:05:08,5,1005,480,540,2,2027
23:05:09,5,1004,488,541,1,2034
23:05:10,5,1005,497,541,2,2045
23:05:11,5,1005,496,541,2,2044
23:05:12,5,1005,498,541,2,2046
23:05:13,5,1005,495,541,1,2042
23:05:14,5,1005,486,541,1,2033
23:05:15,5,1005,494,541,0,2040
23:05:16,5,1005,497,541,1,2044
23:05:17,5,1006,493,541,2,2042
23:05:18,5,1006,498,541,2,2047
23:05:19,5,1006,495,541,0,2042
23:05:20,5,1006,499,541,1,2047
23:05:21,5,1005,491,541,1,2038
23:05:22,5,1006,497,541,1,2045
23:05:23,5,1006,499,541,1,2047
23:05:24,5,1006,487,542,1,2036
23:05:25,5,1006,495,541,0,2042
23:05:26,5,1006,497,542,0,2045
23:05:27,5,1006,492,542,1,2041
23:05:28,5,1007,492,542,2,2043
23:05:29,5,1006,502,542,1,2051
23:05:30,5,1007,492,542,1,2042
23:05:31,5,1006,495,542,1,2044
23:05:32,5,1007,496,542,1,2046
23:05:33,5,1006,496,542,0,2044
23:05:34,5,1006,497,542,1,2046
23:05:35,5,1007,490,542,1,2040
23:05:36,5,1007,499,542,1,2049
23:05:37,5,1007,500,542,1,2050
23:05:38,5,1007,497,542,1,2047
23:05:39,5,1006,503,542,1,2052
23:05:40,5,1006,490,542,1,2039
23:05:41,5,1006,493,542,1,2042
23:05:42,5,1007,502,542,2,2053
23:05:43,5,1006,496,542,0,2044
23:05:44,5,1005,494,542,0,2041
23:05:45,5,1006,496,542,2,2046
23:05:46,5,1006,493,542,1,2042
23:05:47,5,1008,468,542,1,2019
23:05:48,5,1007,495,542,2,2046
23:05:49,5,1007,475,542,1,2025
23:05:50,5,1007,463,542,1,2013
23:05:51,5,1007,493,542,0,2042
23:05:52,5,1006,489,542,1,2038
23:05:53,5,1006,496,542,1,2045
23:05:54,5,1007,478,542,2,2029
23:05:55,5,1007,493,542,1,2043
23:05:56,5,1006,495,542,0,2043
23:05:57,5,1007,494,543,2,2046
23:05:58,5,1007,488,543,1,2039
23:05:59,5,1006,502,543,2,2053
23:06:00,5,1006,500,543,1,2050
23:06:01,5,1006,497,543,1,2047
23:06:02,5,1006,491,543,1,2041
23:06:03,5,1006,482,543,1,2032
23:06:04,5,1005,486,543,1,2035
23:06:05,5,1006,496,543,0,2045
23:06:06,5,1006,497,543,2,2048
23:06:07,5,1006,506,543,0,2055
23:06:08,5,1005,486,543,0,2034
23:06:09,5,1006,496,543,1,2046
23:06:10,5,1006,493,544,2,2045
23:06:11,5,1006,491,544,2,2043
23:06:12,5,1005,492,544,1,2042
23:06:13,5,997,497,543,1,2038
23:06:14,5,1006,492,544,0,2042
23:06:15,5,1005,499,544,1,2049
23:06:16,5,999,497,543,2,2041
23:06:17,5,1006,491,543,1,2041
23:06:18,5,1006,483,544,0,2033
23:06:19,5,1006,492,543,1,2042
23:06:20,5,1006,495,544,1,2046
23:06:21,5,1005,489,544,1,2039
23:06:22,5,1006,497,543,2,2048
23:06:23,5,1005,478,543,1,2027
23:06:24,5,1005,486,543,1,2035
23:06:25,5,1005,490,543,2,2040
23:06:26,5,1005,493,543,0,2041
23:06:27,5,1005,486,543,0,2034
23:06:28,5,1005,493,543,0,2041
23:06:29,5,1005,489,543,1,2038
23:06:30,5,1005,500,544,1,2050
23:06:31,5,1006,487,543,1,2037
23:06:32,5,1005,494,543,2,2044
23:06:33,5,1005,499,543,0,2047
23:06:34,5,1005,488,543,1,2037
23:06:35,5,1004,492,543,2,2041
23:06:36,5,1004,482,543,2,2031
23:06:37,5,1005,478,542,1,2026
23:06:38,5,1004,489,542,1,2036
23:06:39,5,1005,489,542,1,2037
23:06:40,5,1005,501,543,1,2050
23:06:41,5,1004,498,542,1,2045
23:06:42,5,1005,499,543,1,2048
23:06:43,5,1004,500,543,1,2048
23:06:44,5,1004,486,543,0,2033
23:06:45,5,1004,498,542,0,2044
23:06:46,5,1004,495,543,1,2043
23:06:47,5,1004,504,542,1,2051
23:06:48,5,1004,496,542,1,2043
23:06:49,5,1004,578,542,1,2125
23:06:50,5,1004,501,542,1,2048
23:06:51,5,1003,494,542,0,2039
23:06:52,5,1003,500,542,0,2045
23:06:53,5,1003,501,542,1,2047
23:06:54,5,1003,500,541,1,2045
23:06:55,5,1003,511,541,0,2055
23:06:56,5,1003,530,541,1,2075
23:06:57,5,1003,480,541,1,2025
23:06:58,5,1003,499,541,0,2043
23:06:59,5,1003,499,541,1,2044
23:07:00,5,1002,500,541,2,2045
23:07:01,5,1003,498,541,2,2044
23:07:02,5,1003,498,541,0,2042
23:07:03,5,1003,497,541,0,2041
23:07:04,5,1003,488,541,1,2033
23:07:05,5,1001,494,534,0,2029
22:50:41,6,0,0,0,0,0
22:50:42,6,994,478,531,0,2003
22:50:43,6,0,0,0,0,0
22:50:44,6,994,489,531,0,2014
22:50:45,6,0,0,0,0,0
22:50:46,6,0,0,0,0,0
22:50:47,6,0,0,0,0,0
22:50:48,6,994,488,532,0,2014
22:50:49,6,0,0,0,0,0
22:50:50,6,0,0,0,0,0
22:50:51,6,0,0,0,0,0
22:50:52,6,0,0,0,0,0
22:50:53,6,0,0,0,0,0
22:50:54,6,994,480,531,0,2005
22:50:55,6,996,465,531,0,1992
22:50:56,6,996,488,531,0,2015
22:50:57,6,0,0,0,0,0
22:50:58,6,0,0,0,0,0
22:50:59,6,994,491,531,0,2016
22:51:00,6,994,487,531,0,2012
22:51:01,6,994,458,531,0,1983
22:51:02,6,995,472,531,0,1998
22:51:03,6,994,481,532,0,2007
22:51:04,6,0,0,0,0,0
22:51:05,6,995,499,532,0,2026
22:51:06,6,995,486,532,0,2013
22:51:07,6,0,0,0,0,0
22:51:08,6,995,475,532,0,2002
22:51:09,6,0,0,0,0,0
22:51:10,6,995,492,532,0,2019
22:51:11,6,995,494,532,0,2021
22:51:12,6,995,478,532,0,2005
22:51:13,6,0,0,0,0,0
22:51:14,6,0,0,0,0,0
22:51:15,6,995,494,532,0,2021
22:51:16,6,0,0,0,0,0
22:51:17,6,0,0,0,0,0
22:51:18,6,994,481,532,0,2007
22:51:19,6,995,475,532,0,2002
22:51:20,6,0,0,0,0,0
22:51:21,6,0,0,0,0,0
22:51:22,6,994,460,532,0,1986
22:51:23,6,994,477,532,0,2003
22:51:24,6,0,0,0,0,0
22:51:25,6,995,486,532,0,2013
22:51:26,6,0,0,0,0,0
22:51:27,6,994,499,532,0,2025
22:51:28,6,0,0,0,0,0
22:51:29,6,0,0,0,0,0
22:51:30,6,0,0,0,0,0
22:51:31,6,0,0,0,0,0
22:51:32,6,0,0,0,0,0
22:51:33,6,994,435,531,0,1960
22:51:34,6,994,484,531,0,2009
22:51:35,6,993,509,532,0,2034
22:51:36,6,993,487,531,0,2011
22:51:37,6,993,483,531,0,2007
22:51:38,6,993,486,531,162,2172
22:51:39,6,993,484,532,70,2079
22:51:40,6,994,483,531,151,2159
22:51:41,6,994,487,531,531,2543
22:51:42,6,994,478,532,385,2389
22:51:43,6,0,0,0,0,0
22:51:44,6,994,491,532,369,2386
22:51:45,6,994,484,532,415,2425
22:51:46,6,0,0,0,0,0
22:51:47,6,993,473,531,406,2403
22:51:48,6,993,490,531,574,2588
22:51:49,6,994,485,531,418,2428
22:51:50,6,993,482,531,490,2496
22:51:51,6,993,490,531,449,2463
22:51:52,6,993,494,531,665,2683
22:51:53,6,993,486,531,495,2505
22:51:54,6,993,487,531,501,2512
22:51:55,6,993,493,532,683,2701
22:51:56,6,993,479,532,509,2513
22:51:57,6,993,493,533,382,2401
22:51:58,6,0,0,0,0,0
22:51:59,6,996,487,538,404,2425
22:52:00,6,997,501,543,402,2443
22:52:01,6,996,504,548,480,2528
22:52:02,6,996,488,552,447,2483
22:52:03,6,0,0,0,0,0
22:52:04,6,995,482,559,516,2552
22:52:05,6,994,499,560,426,2479
22:52:06,6,994,525,567,605,2691
22:52:07,6,994,525,567,689,2775
22:52:08,6,995,495,567,412,2469
22:52:09,6,993,518,570,525,2606
22:52:10,6,994,492,576,512,2574
22:52:11,6,995,505,580,494,2574
22:52:12,6,994,495,584,556,2629
22:52:13,6,994,502,585,449,2530
22:52:14,6,994,527,586,560,2667
22:52:15,6,993,475,588,442,2498
22:52:16,6,993,479,592,498,2562
22:52:17,6,993,523,595,466,2577
22:52:18,6,993,450,598,550,2591
22:52:19,6,993,482,602,467,2544
22:52:20,6,0,0,0,0,0
22:52:21,6,0,0,0,0,0
22:52:22,6,993,465,613,562,2633
22:52:23,6,993,484,614,587,2678
22:52:24,6,993,486,616,405,2500
22:52:25,6,993,498,620,485,2596
22:52:26,6,994,495,622,515,2626
22:52:27,6,992,499,624,477,2592
22:52:28,6,992,537,624,313,2466
22:52:29,6,0,0,0,0,0
22:52:30,6,992,485,630,492,2599
22:52:31,6,992,491,632,412,2527
22:52:32,6,992,482,634,362,2470
22:52:33,6,992,488,638,902,3020
22:52:34,6,992,498,638,876,3004
22:52:35,6,991,511,643,863,3008
22:52:36,6,991,473,646,924,3034
22:52:37,6,991,474,649,868,2982
22:52:38,6,991,490,650,852,2983
22:52:39,6,991,488,652,891,3022
22:52:40,6,990,474,653,897,3014
22:52:41,6,990,506,655,888,3039
22:52:42,6,990,489,656,892,3027
22:52:43,6,991,483,658,878,3010
22:52:44,6,990,482,658,854,2984
22:52:45,6,991,487,659,916,3053
22:52:46,6,990,485,660,998,3133
22:52:47,6,991,505,660,943,3099
22:52:48,6,991,494,661,936,3082
22:52:49,6,0,0,0,0,0
22:52:50,6,0,0,0,0,0
22:52:51,6,0,0,0,0,0
22:52:52,6,0,0,0,0,0
22:52:53,6,0,0,0,0,0
22:52:54,6,991,478,663,768,2900
22:52:55,6,0,0,0,0,0
22:52:56,6,0,0,0,0,0
22:52:57,6,991,495,666,887,3039
22:52:58,6,0,0,0,0,0
22:52:59,6,0,0,0,0,0
22:53:00,6,0,0,0,0,0
22:53:01,6,0,0,0,0,0
22:53:02,6,991,500,665,856,3012
22:53:03,6,0,0,0,0,0
22:53:04,6,991,499,666,905,3061
22:53:05,6,0,0,0,0,0
22:53:06,6,991,484,665,869,3009
22:53:07,6,0,0,0,0,0
22:53:08,6,0,0,0,0,0
22:53:09,6,0,0,0,0,0
22:53:10,6,0,0,0,0,0
22:53:11,6,0,0,0,0,0
22:53:12,6,0,0,0,0,0
22:53:13,6,991,488,675,906,3060
22:53:14,6,0,0,0,0,0
22:53:15,6,0,0,0,0,0
22:53:16,6,0,0,0,0,0
22:53:17,6,992,489,681,945,3107
22:53:18,6,991,499,685,813,2988
22:53:19,6,991,483,685,875,3034
22:53:20,6,0,0,0,0,0
22:53:21,6,991,507,688,879,3065
22:53:22,6,0,0,0,0,0
22:53:23,6,991,482,694,881,3048
22:53:24,6,991,483,696,801,2971
22:53:25,6,0,0,0,0,0
22:53:26,6,0,0,0,0,0
22:53:27,6,0,0,0,0,0
22:53:28,6,0,0,0,0,0
22:53:29,6,993,495,705,985,3178
22:53:30,6,0,0,0,0,0
22:53:31,6,994,482,713,874,3063
22:53:32,6,993,499,714,780,2986
22:53:33,6,991,495,717,991,3194
22:53:34,6,0,0,0,0,0
22:53:35,6,991,364,722,984,3061
22:53:36,6,0,0,0,0,0
22:53:37,6,0,0,0,0,0
22:53:38,6,990,470,724,849,3033
22:53:39,6,0,0,0,0,0
22:53:40,6,990,493,725,917,3125
22:53:41,6,0,0,0,0,0
22:53:42,6,0,0,0,0,0
22:53:43,6,0,0,0,0,0
22:53:44,6,990,498,731,866,3085
22:53:45,6,990,501,732,977,3200
22:53:46,6,990,498,734,858,3080
22:53:47,6,0,0,0,0,0
22:53:48,6,0,0,0,0,0
22:53:49,6,990,482,737,992,3201
22:53:50,6,991,487,738,930,3146
22:53:51,6,990,490,739,847,3066
22:53:52,6,990,485,739,795,3009
22:53:53,6,990,495,739,868,3092
22:53:54,6,991,486,741,806,3024
22:53:55,6,991,485,737,890,3103
22:53:56,6,990,484,737,928,3139
22:53:57,6,0,0,0,0,0
22:53:58,6,991,484,734,945,3154
22:53:59,6,0,0,0,0,0
22:54:00,6,990,494,732,823,3039
22:54:01,6,991,501,732,781,3005
22:54:02,6,0,0,0,0,0
22:54:03,6,0,0,0,0,0
22:54:04,6,991,487,731,843,3052
22:54:05,6,0,0,0,0,0
22:54:06,6,0,0,0,0,0
22:54:07,6,991,484,731,818,3024
22:54:08,6,0,0,0,0,0
22:54:09,6,991,497,732,877,3097
22:54:10,6,990,494,732,819,3035
22:54:11,6,0,0,0,0,0
22:54:12,6,991,491,729,894,3105
22:54:13,6,991,497,729,932,3149
22:54:14,6,0,0,0,0,0
22:54:15,6,0,0,0,0,0
22:54:16,6,993,498,733,814,3038
22:54:17,6,992,520,736,927,3175
22:54:18,6,991,481,737,853,3062
22:54:19,6,991,487,738,792,3008
22:54:20,6,991,481,739,849,3060
22:54:21,6,991,488,740,912,3131
22:54:22,6,0,0,0,0,0
22:54:23,6,0,0,0,0,0
22:54:24,6,990,473,740,788,2991
22:54:25,6,991,491,742,945,3169
22:54:26,6,0,0,0,0,0
22:54:27,6,991,488,743,844,3066
22:54:28,6,0,0,0,0,0
22:54:29,6,991,494,743,951,3179
22:54:30,6,991,497,743,878,3109
22:54:31,6,991,484,744,876,3095
22:54:32,6,0,0,0,0,0
22:54:33,6,991,486,744,971,3192
22:54:34,6,0,0,0,0,0
22:54:35,6,991,504,744,982,3221
22:54:36,6,992,496,743,881,3112
22:54:37,6,992,494,743,876,3105
22:54:38,6,992,482,743,867,3084
22:54:39,6,991,500,742,882,3115
22:54:40,6,992,490,741,975,3198
22:54:41,6,993,493,741,760,2987
22:54:42,6,992,490,740,840,3062
22:54:43,6,992,488,739,829,3048
22:54:44,6,993,471,739,797,3000
22:54:45,6,992,491,741,832,3056
22:54:46,6,991,494,741,851,3077
22:54:47,6,991,489,740,882,3102
22:54:48,6,992,498,739,825,3054
22:54:49,6,992,482,738,863,3075
22:54:50,6,992,491,738,871,3092
22:54:51,6,991,495,738,850,3074
22:54:52,6,992,487,737,845,3061
22:54:53,6,0,0,0,0,0
22:54:54,6,989,487,734,858,3068
22:54:55,6,990,485,732,925,3132
22:54:56,6,990,491,732,842,3055
22:54:57,6,993,493,734,953,3173
22:54:58,6,994,487,734,765,2980
22:54:59,6,992,496,735,897,3120
22:55:00,6,993,487,735,860,3075
22:55:01,6,991,504,736,870,3101
22:55:02,6,0,0,0,0,0
22:55:03,6,992,491,734,867,3084
22:55:04,6,992,494,733,845,3064
22:55:05,6,993,501,731,873,3098
22:55:06,6,993,494,730,865,3082
22:55:07,6,993,472,729,885,3079
22:55:08,6,994,444,728,811,2977
22:55:09,6,994,483,727,891,3095
22:55:10,6,994,488,727,910,3119
22:55:11,6,995,490,726,879,3090
22:55:12,6,995,487,724,856,3062
22:55:13,6,995,485,723,883,3086
22:55:14,6,994,489,720,886,3089
22:55:15,6,995,484,720,855,3054
22:55:16,6,995,494,721,844,3054
22:55:17,6,996,482,721,886,3085
22:55:18,6,995,482,721,916,3114
22:55:19,6,996,488,720,859,3063
22:55:20,6,995,476,718,902,3091
22:55:21,6,995,509,719,845,3068
22:55:22,6,994,482,719,863,3058
22:55:23,6,994,479,717,815,3005
22:55:24,6,995,498,717,870,3080
22:55:25,6,994,567,717,903,3181
22:55:26,6,995,490,718,823,3026
22:55:27,6,0,0,0,0,0
22:55:28,6,994,488,718,876,3076
22:55:29,6,996,486,719,854,3055
22:55:30,6,995,481,719,900,3095
22:55:31,6,996,491,718,916,3121
22:55:32,6,992,487,719,878,3076
22:55:33,6,996,489,719,904,3108
22:55:34,6,995,492,717,870,3074
22:55:35,6,0,0,0,0,0
22:55:36,6,996,490,716,873,3075
22:55:37,6,995,488,715,788,2986
22:55:38,6,995,488,715,957,3155
22:55:39,6,995,488,715,865,3063
22:55:40,6,994,485,714,852,3045
22:55:41,6,996,493,714,929,3132
22:55:42,6,994,488,713,799,2994
22:55:43,6,995,493,713,829,3030
22:55:44,6,995,493,714,872,3074
22:55:45,6,995,491,714,885,3085
22:55:46,6,996,490,714,932,3132
22:55:47,6,996,494,713,803,3006
22:55:48,6,995,522,714,859,3090
22:55:49,6,995,485,714,865,3059
22:55:50,6,994,482,713,886,3075
22:55:51,6,994,498,712,994,3198
22:55:52,6,994,483,711,908,3096
22:55:53,6,995,480,710,906,3091
22:55:54,6,995,495,708,888,3086
22:55:55,6,996,499,708,906,3109
22:55:56,6,0,0,0,0,0
22:55:57,6,995,482,704,907,3088
22:55:58,6,996,483,703,872,3054
22:55:59,6,995,487,702,876,3060
22:56:00,6,995,487,702,840,3024
22:56:01,6,994,483,701,802,2980
22:56:02,6,994,498,701,798,2991
22:56:03,6,995,487,700,851,3033
22:56:04,6,995,499,699,865,3058
22:56:05,6,996,483,698,926,3103
22:56:06,6,995,494,699,865,3053
22:56:07,6,995,497,699,919,3110
22:56:08,6,995,486,699,885,3065
22:56:09,6,994,497,699,890,3080
22:56:10,6,996,476,699,877,3048
22:56:11,6,995,484,698,887,3064
22:56:12,6,995,493,697,878,3063
22:56:13,6,995,488,696,913,3092
22:56:14,6,996,497,696,828,3017
22:56:15,6,995,504,696,880,3075
22:56:16,6,995,490,696,762,2943
22:56:17,6,995,481,695,909,3080
22:56:18,6,995,485,694,436,2610
22:56:19,6,995,492,694,642,2823
22:56:20,6,995,482,695,498,2670
22:56:21,6,995,496,695,503,2689
22:56:22,6,995,479,696,485,2655
22:56:23,6,996,499,696,442,2633
22:56:24,6,995,496,697,483,2671
22:56:25,6,996,495,698,389,2578
22:56:26,6,995,494,698,373,2560
22:56:27,6,995,493,698,544,2730
22:56:28,6,995,489,698,781,2963
22:56:29,6,995,484,698,727,2904
22:56:30,6,996,471,699,585,2751
22:56:31,6,995,502,699,401,2597
22:56:32,6,995,479,698,606,2778
22:56:33,6,993,497,697,512,2699
22:56:34,6,0,0,0,0,0
22:56:35,6,995,499,695,596,2785
22:56:36,6,994,485,695,680,2854
22:56:37,6,995,503,692,740,2930
22:56:38,6,994,506,693,542,2735
22:56:39,6,995,492,694,506,2687
22:56:40,6,995,505,695,648,2843
22:56:41,6,0,0,0,0,0
22:56:42,6,0,0,0,0,0
22:56:43,6,995,485,699,474,2653
22:56:44,6,996,496,704,767,2963
22:56:45,6,995,499,707,552,2753
22:56:46,6,994,483,706,564,2747
22:56:47,6,994,490,705,586,2775
22:56:48,6,994,492,707,449,2642
22:56:49,6,994,484,707,339,2524
22:56:50,6,994,485,709,560,2748
22:56:51,6,993,487,709,371,2560
22:56:52,6,993,488,710,486,2677
22:56:53,6,993,489,710,559,2751
22:56:54,6,994,493,710,534,2731
22:56:55,6,993,490,711,614,2808
22:56:56,6,993,477,711,643,2824
22:56:57,6,993,494,711,544,2742
22:56:58,6,993,485,711,391,2580
22:56:59,6,993,488,712,900,3093
22:57:00,6,993,489,711,896,3089
22:57:01,6,994,496,711,861,3062
22:57:02,6,993,495,710,916,3114
22:57:03,6,0,0,0,0,0
22:57:04,6,993,486,710,963,3152
22:57:05,6,993,493,710,911,3107
22:57:06,6,993,483,708,892,3076
22:57:07,6,993,493,709,919,3114
22:57:08,6,993,479,710,940,3122
22:57:09,6,993,494,709,880,3076
22:57:10,6,994,483,709,985,3171
22:57:11,6,994,483,708,919,3104
22:57:12,6,0,0,0,0,0
22:57:13,6,0,0,0,0,0
22:57:14,6,993,488,709,854,3044
22:57:15,6,994,484,709,904,3091
22:57:16,6,993,496,708,932,3129
22:57:17,6,993,498,706,850,3047
22:57:18,6,993,493,704,918,3108
22:57:19,6,994,490,701,905,3090
22:57:20,6,993,491,701,503,2688
22:57:21,6,993,491,701,452,2637
22:57:22,6,993,485,701,508,2687
22:57:23,6,993,492,702,559,2746
22:57:24,6,993,484,703,624,2804
22:57:25,6,993,491,703,486,2673
22:57:26,6,993,493,703,467,2656
22:57:27,6,994,486,703,519,2702
22:57:28,6,994,496,701,608,2799
22:57:29,6,994,492,699,374,2559
22:57:30,6,994,495,698,514,2701
22:57:31,6,993,497,696,474,2660
22:57:32,6,993,495,695,552,2735
22:57:33,6,993,485,692,485,2655
22:57:34,6,993,489,690,548,2720
22:57:35,6,0,0,0,0,0
22:57:36,6,0,0,0,0,0
22:57:37,6,0,0,0,0,0
22:57:38,6,0,0,0,0,0
22:57:39,6,0,0,0,0,0
22:57:40,6,0,0,0,0,0
22:57:41,6,0,0,0,0,0
22:57:42,6,994,485,685,340,2504
22:57:43,6,994,497,687,454,2632
22:57:44,6,993,485,687,598,2763
22:57:45,6,0,0,0,0,0
22:57:46,6,993,494,688,591,2766
22:57:47,6,0,0,0,0,0
22:57:48,6,993,488,687,577,2745
22:57:49,6,994,484,686,460,2624
22:57:50,6,993,491,687,494,2665
22:57:51,6,0,0,0,0,0
22:57:52,6,994,485,687,529,2695
22:57:53,6,992,486,686,494,2658
22:57:54,6,993,493,684,592,2762
22:57:55,6,994,482,682,491,2649
22:57:56,6,993,488,681,507,2669
22:57:57,6,0,0,0,0,0
22:57:58,6,993,493,679,641,2806
22:57:59,6,994,484,679,327,2484
22:58:00,6,993,495,678,437,2603
22:58:01,6,994,490,677,524,2685
22:58:02,6,993,483,674,865,3015
22:58:03,6,993,487,673,881,3034
22:58:04,6,994,468,672,895,3029
22:58:05,6,993,489,670,935,3087
22:58:06,6,993,491,669,920,3073
22:58:07,6,993,485,668,907,3053
22:58:08,6,993,483,667,853,2996
22:58:09,6,993,491,666,900,3050
22:58:10,6,993,491,665,869,3018
22:58:11,6,993,485,664,839,2981
22:58:12,6,993,489,664,992,3138
22:58:13,6,0,0,0,0,0
22:58:14,6,992,492,664,915,3063
22:58:15,6,993,489,665,928,3075
22:58:16,6,992,494,665,897,3048
22:58:17,6,992,491,666,889,3038
22:58:18,6,992,482,667,996,3137
22:58:19,6,992,498,668,863,3021
22:58:20,6,992,485,670,930,3077
22:58:21,6,993,487,671,893,3044
22:58:22,6,993,493,672,885,3043
22:58:23,6,992,489,671,899,3051
22:58:24,6,992,491,672,874,3029
22:58:25,6,993,489,672,886,3040
22:58:26,6,992,487,673,880,3032
22:58:27,6,992,492,673,884,3041
22:58:28,6,992,489,672,866,3019
22:58:29,6,991,493,672,878,3034
22:58:30,6,991,487,672,929,3079
22:58:31,6,991,476,671,910,3048
22:58:32,6,992,488,671,940,3091
22:58:33,6,991,483,671,897,3042
22:58:34,6,991,494,671,873,3029
22:58:35,6,0,0,0,0,0
22:58:36,6,991,481,671,377,2520
22:58:37,6,991,494,670,552,2707
22:58:38,6,991,502,669,630,2792
22:58:39,6,992,493,668,617,2770
22:58:40,6,992,497,668,554,2711
22:58:41,6,992,483,667,516,2658
22:58:42,6,992,494,667,533,2686
22:58:43,6,992,495,667,553,2707
22:58:44,6,992,482,668,503,2645
22:58:45,6,992,491,667,533,2683
22:58:46,6,992,481,666,596,2735
22:58:47,6,992,495,665,588,2740
22:58:48,6,992,487,663,460,2602
22:58:49,6,992,486,663,576,2717
22:58:50,6,991,491,663,398,2543
22:58:51,6,992,483,663,567,2705
22:58:52,6,0,0,0,0,0
22:58:53,6,992,493,665,895,3045
22:58:54,6,992,495,665,898,3050
22:58:55,6,991,467,666,839,2963
22:58:56,6,992,488,667,938,3085
22:58:57,6,991,498,668,959,3116
22:58:58,6,992,466,669,899,3026
22:58:59,6,991,485,670,889,3035
22:59:00,6,991,489,672,872,3024
22:59:01,6,991,485,674,905,3055
22:59:02,6,0,0,0,0,0
22:59:03,6,991,507,677,945,3120
22:59:04,6,990,489,678,898,3055
22:59:05,6,990,497,679,853,3019
22:59:06,6,990,477,680,923,3070
22:59:07,6,990,499,679,882,3050
22:59:08,6,990,493,680,917,3080
22:59:09,6,991,490,681,876,3038
22:59:10,6,990,490,681,917,3078
22:59:11,6,991,481,681,827,2980
22:59:12,6,991,493,681,940,3105
22:59:13,6,991,495,681,932,3099
22:59:14,6,991,496,681,825,2993
22:59:15,6,991,488,679,910,3068
22:59:16,6,991,492,678,966,3127
22:59:17,6,991,490,677,871,3029
22:59:18,6,990,491,676,902,3059
22:59:19,6,991,488,675,935,3089
22:59:20,6,990,489,674,871,3024
22:59:21,6,991,487,675,909,3062
22:59:22,6,991,487,675,837,2990
22:59:23,6,991,486,675,919,3071
22:59:24,6,990,488,675,922,3075
22:59:25,6,990,495,675,907,3067
22:59:26,6,991,515,675,906,3087
22:59:27,6,991,482,676,929,3078
22:59:28,6,991,497,676,866,3030
22:59:29,6,991,483,675,999,3148
22:59:30,6,991,486,674,950,3101
22:59:31,6,990,480,674,907,3051
22:59:32,6,991,489,675,918,3073
22:59:33,6,990,480,674,900,3044
22:59:34,6,991,474,671,872,3008
22:59:35,6,991,491,669,925,3076
22:59:36,6,991,478,668,901,3038
22:59:37,6,991,495,667,900,3053
22:59:38,6,991,495,665,894,3045
22:59:39,6,991,499,663,888,3041
22:59:40,6,991,487,663,900,3041
22:59:41,6,991,511,661,921,3084
22:59:42,6,992,490,660,886,3028
22:59:43,6,991,490,659,896,3036
22:59:44,6,991,495,659,946,3091
22:59:45,6,991,487,657,888,3023
22:59:46,6,991,487,657,906,3041
22:59:47,6,991,492,657,866,3006
22:59:48,6,992,493,656,911,3052
22:59:49,6,991,472,655,949,3067
22:59:50,6,992,492,655,891,3030
22:59:51,6,991,492,655,924,3062
22:59:52,6,991,495,655,867,3008
22:59:53,6,992,490,655,898,3035
22:59:54,6,992,490,654,867,3003
22:59:55,6,992,494,653,909,3048
22:59:56,6,992,492,653,901,3038
22:59:57,6,992,492,654,918,3056
22:59:58,6,992,489,654,859,2994
22:59:59,6,992,496,654,892,3034
23:00:00,6,992,491,655,887,3025
23:00:01,6,992,495,654,917,3058
23:00:02,6,992,490,654,898,3034
23:00:03,6,991,489,654,887,3021
23:00:04,6,991,488,654,912,3045
23:00:05,6,991,489,654,858,2992
23:00:06,6,991,489,654,882,3016
23:00:07,6,991,490,653,890,3024
23:00:08,6,991,491,653,915,3050
23:00:09,6,991,492,653,925,3061
23:00:10,6,991,488,653,934,3066
23:00:11,6,991,494,653,898,3036
23:00:12,6,992,487,652,903,3034
23:00:13,6,992,491,651,875,3009
23:00:14,6,992,495,651,927,3065
23:00:15,6,992,495,651,919,3057
23:00:16,6,992,495,649,895,3031
23:00:17,6,992,491,649,938,3070
23:00:18,6,992,490,649,899,3030
23:00:19,6,991,485,648,928,3052
23:00:20,6,991,480,648,919,3038
23:00:21,6,991,461,648,890,2990
23:00:22,6,992,497,649,897,3035
23:00:23,6,991,489,652,891,3023
23:00:24,6,991,487,653,915,3046
23:00:25,6,991,489,655,902,3037
23:00:26,6,990,484,654,912,3040
23:00:27,6,991,488,655,931,3065
23:00:28,6,991,477,655,896,3019
23:00:29,6,991,493,656,916,3056
23:00:30,6,991,486,656,891,3024
23:00:31,6,990,479,656,895,3020
23:00:32,6,990,487,656,867,3000
23:00:33,6,991,488,656,922,3057
23:00:34,6,991,488,656,897,3032
23:00:35,6,991,491,656,912,3050
23:00:36,6,991,487,657,908,3043
23:00:37,6,991,490,657,893,3031
23:00:38,6,991,490,657,915,3053
23:00:39,6,991,493,657,941,3082
23:00:40,6,991,487,656,963,3097
23:00:41,6,991,490,656,944,3081
23:00:42,6,991,496,656,963,3106
23:00:43,6,990,491,656,944,3081
23:00:44,6,991,491,656,941,3079
23:00:45,6,991,493,655,961,3100
23:00:46,6,990,489,654,951,3084
23:00:47,6,990,489,653,956,3088
23:00:48,6,990,489,653,950,3082
23:00:49,6,991,487,651,952,3081
23:00:50,6,991,493,650,957,3091
23:00:51,6,991,484,649,942,3066
23:00:52,6,992,488,649,952,3081
23:00:53,6,991,494,648,951,3084
23:00:54,6,991,488,648,947,3074
23:00:55,6,991,488,647,945,3071
23:00:56,6,991,485,647,947,3070
23:00:57,6,991,494,647,948,3080
23:00:58,6,991,489,647,136,2263
23:00:59,6,991,488,646,144,2269
23:01:00,6,991,494,646,134,2265
23:01:01,6,991,494,646,146,2277
23:01:02,6,991,489,645,131,2256
23:01:03,6,991,486,644,122,2243
23:01:04,6,991,496,644,145,2276
23:01:05,6,990,487,643,164,2284
23:01:06,6,991,481,643,130,2245
23:01:07,6,0,0,0,0,0
23:01:08,6,991,501,641,147,2280
23:01:09,6,991,515,640,138,2284
23:01:10,6,990,519,640,180,2329
23:01:11,6,990,483,639,139,2251
23:01:12,6,991,500,639,88,2218
23:01:13,6,990,521,637,131,2279
23:01:14,6,991,505,635,150,2281
23:01:15,6,991,491,633,122,2237
23:01:16,6,991,484,632,40,2147
23:01:17,6,991,487,630,50,2158
23:01:18,6,991,500,629,87,2207
23:01:19,6,991,478,628,1,2098
23:01:20,6,991,519,626,3,2139
23:01:21,6,991,501,624,2,2118
23:01:22,6,991,514,623,1,2129
23:01:23,6,991,488,622,2,2103
23:01:24,6,991,503,621,1,2116
23:01:25,6,991,501,620,2,2114
23:01:26,6,991,539,619,2,2151
23:01:27,6,991,513,618,2,2124
23:01:28,6,991,498,617,5,2111
23:01:29,6,991,514,616,1,2122
23:01:30,6,991,487,616,4,2098
23:01:31,6,991,476,616,3,2086
23:01:32,6,991,492,615,3,2101
23:01:33,6,991,439,614,1,2045
23:01:34,6,991,496,614,1,2102
23:01:35,6,991,510,614,1,2116
23:01:36,6,991,522,613,3,2129
23:01:37,6,991,451,612,5,2059
23:01:38,6,991,476,612,2,2081
23:01:39,6,991,454,612,2,2059
23:01:40,6,991,504,611,3,2109
23:01:41,6,991,475,611,1,2078
23:01:42,6,991,483,610,2,2086
23:01:43,6,0,0,0,0,0
23:01:44,6,0,0,0,0,0
23:01:45,6,0,0,0,0,0
23:01:46,6,0,0,0,0,0
23:01:47,6,0,0,0,0,0
23:01:48,6,991,477,608,2,2078
23:01:49,6,991,533,608,4,2136
23:01:50,6,0,0,0,0,0
23:01:51,6,0,0,0,0,0
23:01:52,6,0,0,0,0,0
23:01:53,6,0,0,0,0,0
23:01:54,6,991,533,605,0,2129
23:01:55,6,991,475,605,1,2072
23:01:56,6,991,475,604,2,2072
23:01:57,6,0,0,0,0,0
23:01:58,6,0,0,0,0,0
23:01:59,6,0,0,0,0,0
23:02:00,6,0,0,0,0,0
23:02:01,6,0,0,0,0,0
23:02:02,6,0,0,0,0,0
23:02:03,6,0,0,0,0,0
23:02:04,6,0,0,0,0,0
23:02:05,6,991,499,602,1,2093
23:02:06,6,0,0,0,0,0
23:02:07,6,991,507,601,1,2100
23:02:08,6,991,523,601,1,2116
23:02:09,6,991,474,599,1,2065
23:02:10,6,991,489,599,0,2079
23:02:11,6,991,493,598,1,2083
23:02:12,6,991,500,597,1,2089
23:02:13,6,991,504,597,0,2092
23:02:14,6,991,459,596,1,2047
23:02:15,6,991,521,594,1,2107
23:02:16,6,991,506,593,0,2090
23:02:17,6,992,498,592,1,2083
23:02:18,6,992,490,592,1,2075
23:02:19,6,992,494,592,1,2079
23:02:20,6,991,488,592,1,2072
23:02:21,6,992,489,591,1,2073
23:02:22,6,991,486,590,0,2067
23:02:23,6,991,490,589,0,2070
23:02:24,6,991,495,589,0,2075
23:02:25,6,991,487,589,0,2067
23:02:26,6,992,491,588,1,2072
23:02:27,6,992,488,587,1,2068
23:02:28,6,992,489,587,0,2068
23:02:29,6,992,490,586,1,2069
23:02:30,6,991,490,586,1,2068
23:02:31,6,991,489,586,1,2067
23:02:32,6,992,492,586,1,2071
23:02:33,6,991,487,585,0,2063
23:02:34,6,992,485,584,1,2062
23:02:35,6,991,488,584,1,2064
23:02:36,6,992,492,584,0,2068
23:02:37,6,991,487,584,1,2063
23:02:38,6,992,493,584,1,2070
23:02:39,6,991,488,583,1,2063
23:02:40,6,991,490,582,0,2063
23:02:41,6,991,485,582,1,2059
23:02:42,6,992,488,581,1,2062
23:02:43,6,992,491,581,1,2065
23:02:44,6,992,488,580,1,2061
23:02:45,6,992,491,580,1,2064
23:02:46,6,992,490,580,1,2063
23:02:47,6,992,489,579,1,2061
23:02:48,6,992,486,579,1,2058
23:02:49,6,992,487,579,1,2059
23:02:50,6,992,487,579,1,2059
23:02:51,6,992,492,579,1,2064
23:02:52,6,991,491,579,0,2061
23:02:53,6,991,494,579,1,2065
23:02:54,6,992,489,579,1,2061
23:02:55,6,992,492,579,1,2064
23:02:56,6,992,478,579,1,2050
23:02:57,6,992,487,579,0,2058
23:02:58,6,992,489,579,0,2060
23:02:59,6,992,480,578,0,2050
23:03:00,6,991,505,578,0,2074
23:03:01,6,992,488,578,1,2059
23:03:02,6,991,454,577,1,2023
23:03:03,6,991,486,577,1,2055
23:03:04,6,991,490,576,1,2058
23:03:05,6,992,493,575,1,2061
23:03:06,6,992,491,573,0,2056
23:03:07,6,992,482,573,1,2048
23:03:08,6,0,0,0,0,0
23:03:09,6,992,470,571,1,2034
23:03:10,6,992,483,570,2,2047
23:03:11,6,0,0,0,0,0
23:03:12,6,992,491,570,0,2053
23:03:13,6,0,0,0,0,0
23:03:14,6,992,487,570,1,2050
23:03:15,6,992,484,569,0,2045
23:03:16,6,992,308,569,0,1869
23:03:17,6,992,489,569,1,2051
23:03:18,6,992,488,568,1,2049
23:03:19,6,992,489,568,0,2049
23:03:20,6,992,491,568,1,2052
23:03:21,6,992,487,568,1,2048
23:03:22,6,992,490,568,1,2051
23:03:23,6,992,490,568,0,2050
23:03:24,6,992,493,568,1,2054
23:03:25,6,992,492,568,1,2053
23:03:26,6,992,491,568,0,2051
23:03:27,6,992,491,568,1,2052
23:03:28,6,992,490,568,1,2051
23:03:29,6,992,492,568,0,2052
23:03:30,6,992,485,568,1,2046
23:03:31,6,992,490,568,0,2050
23:03:32,6,992,486,567,1,2046
23:03:33,6,992,486,567,1,2046
23:03:34,6,992,491,567,0,2050
23:03:35,6,992,492,567,1,2052
23:03:36,6,992,486,566,0,2044
23:03:37,6,992,490,566,1,2049
23:03:38,6,991,489,566,0,2046
23:03:39,6,992,490,566,1,2049
23:03:40,6,992,489,566,0,2047
23:03:41,6,992,494,566,1,2053
23:03:42,6,992,484,566,0,2042
23:03:43,6,992,488,566,1,2047
23:03:44,6,992,489,567,0,2048
23:03:45,6,991,486,567,1,2045
23:03:46,6,992,490,566,1,2049
23:03:47,6,992,493,566,1,2052
23:03:48,6,992,491,566,1,2050
23:03:49,6,992,483,566,1,2042
23:03:50,6,992,497,566,1,2056
23:03:51,6,992,484,566,1,2043
23:03:52,6,992,484,566,1,2043
23:03:53,6,991,486,566,1,2044
23:03:54,6,992,488,566,0,2046
23:03:55,6,992,492,565,1,2050
23:03:56,6,992,489,565,0,2046
23:03:57,6,992,488,565,0,2045
23:03:58,6,992,491,565,0,2048
23:03:59,6,992,489,565,1,2047
23:04:00,6,992,490,565,0,2047
23:04:01,6,992,488,565,1,2046
23:04:02,6,992,486,564,1,2043
23:04:03,6,992,493,564,1,2050
23:04:04,6,992,490,563,1,2046
23:04:05,6,992,492,563,0,2047
23:04:06,6,992,491,563,1,2047
23:04:07,6,992,486,562,0,2040
23:04:08,6,992,487,562,0,2041
23:04:09,6,992,489,561,0,2042
23:04:10,6,992,490,561,0,2043
23:04:11,6,992,489,560,1,2042
23:04:12,6,992,488,560,0,2040
23:04:13,6,992,488,560,0,2040
23:04:14,6,992,490,560,1,2043
23:04:15,6,992,489,559,1,2041
23:04:16,6,992,487,559,0,2038
23:04:17,6,992,488,559,0,2039
23:04:18,6,992,488,559,0,2039
23:04:19,6,992,486,559,0,2037
23:04:20,6,992,490,559,1,2042
23:04:21,6,991,487,559,0,2037
23:04:22,6,992,489,559,1,2041
23:04:23,6,992,489,559,1,2041
23:04:24,6,992,487,559,1,2039
23:04:25,6,991,488,559,1,2039
23:04:26,6,992,487,559,1,2039
23:04:27,6,991,489,559,1,2040
23:04:28,6,991,490,559,1,2041
23:04:29,6,992,487,558,1,2038
23:04:30,6,991,486,558,0,2035
23:04:31,6,991,487,558,0,2036
23:04:32,6,991,491,558,1,2041
23:04:33,6,991,486,558,1,2036
23:04:34,6,991,488,558,1,2038
23:04:35,6,991,487,558,0,2036
23:04:36,6,991,489,558,0,2038
23:04:37,6,991,489,558,1,2039
23:04:38,6,991,486,557,1,2035
23:04:39,6,991,490,557,0,2038
23:04:40,6,991,490,557,0,2038
23:04:41,6,991,489,557,1,2038
23:04:42,6,991,490,557,1,2039
23:04:43,6,991,489,557,1,2038
23:04:44,6,991,488,556,1,2036
23:04:45,6,991,486,556,1,2034
23:04:46,6,991,494,556,1,2042
23:04:47,6,991,485,556,0,2032
23:04:48,6,991,490,556,1,2038
23:04:49,6,991,487,556,0,2034
23:04:50,6,991,492,556,1,2040
23:04:51,6,991,487,555,0,2033
23:04:52,6,991,491,555,1,2038
23:04:53,6,991,489,555,0,2035
23:04:54,6,991,485,555,1,2032
23:04:55,6,991,488,555,0,2034
23:04:56,6,991,486,555,1,2033
23:04:57,6,991,490,555,1,2037
23:04:58,6,991,487,554,0,2032
23:04:59,6,991,489,554,0,2034
23:05:00,6,991,490,555,1,2037
23:05:01,6,991,488,555,1,2035
23:05:02,6,991,490,555,1,2037
23:05:03,6,991,488,555,1,2035
23:05:04,6,991,490,555,0,2036
23:05:05,6,991,489,555,2,2037
23:05:06,6,991,488,555,1,2035
23:05:07,6,991,489,555,0,2035
23:05:08,6,991,488,555,0,2034
23:05:09,6,991,490,554,1,2036
23:05:10,6,991,495,555,1,2042
23:05:11,6,991,489,555,1,2036
23:05:12,6,991,492,554,1,2038
23:05:13,6,991,490,554,0,2035
23:05:14,6,991,487,554,1,2033
23:05:15,6,991,492,554,1,2038
23:05:16,6,991,490,554,1,2036
23:05:17,6,991,487,554,1,2033
23:05:18,6,991,488,554,1,2034
23:05:19,6,991,489,553,1,2034
23:05:20,6,991,491,553,1,2036
23:05:21,6,991,487,553,1,2032
23:05:22,6,991,490,554,1,2036
23:05:23,6,991,485,554,0,2030
23:05:24,6,991,487,554,0,2032
23:05:25,6,991,491,554,0,2036
23:05:26,6,991,490,553,1,2035
23:05:27,6,991,494,553,1,2039
23:05:28,6,991,477,553,1,2022
23:05:29,6,991,491,553,0,2035
23:05:30,6,991,490,552,0,2033
23:05:31,6,991,492,552,1,2036
23:05:32,6,991,491,552,1,2035
23:05:33,6,991,488,552,1,2032
23:05:34,6,991,487,552,1,2031
23:05:35,6,991,487,552,1,2031
23:05:36,6,991,488,552,1,2032
23:05:37,6,991,486,551,0,2028
23:05:38,6,991,482,552,0,2025
23:05:39,6,991,492,552,1,2036
23:05:40,6,991,489,551,1,2032
23:05:41,6,991,486,551,1,2029
23:05:42,6,991,490,551,1,2033
23:05:43,6,991,485,551,0,2027
23:05:44,6,992,488,551,0,2031
23:05:45,6,991,489,550,1,2031
23:05:46,6,992,481,550,1,2024
23:05:47,6,991,479,550,1,2021
23:05:48,6,991,490,550,0,2031
23:05:49,6,992,490,550,1,2033
23:05:50,6,991,486,549,1,2027
23:05:51,6,991,492,549,1,2033
23:05:52,6,992,490,549,1,2032
23:05:53,6,992,489,549,0,2030
23:05:54,6,992,490,549,0,2031
23:05:55,6,992,485,549,0,2026
23:05:56,6,992,493,549,1,2035
23:05:57,6,992,491,549,0,2032
23:05:58,6,991,489,548,0,2028
23:05:59,6,991,489,548,1,2029
23:06:00,6,991,489,548,1,2029
23:06:01,6,992,480,548,1,2021
23:06:02,6,992,491,548,1,2032
23:06:03,6,991,491,548,0,2030
23:06:04,6,992,486,548,1,2027
23:06:05,6,992,490,548,0,2030
23:06:06,6,991,491,548,1,2031
23:06:07,6,992,489,548,1,2030
23:06:08,6,991,492,548,1,2032
23:06:09,6,991,491,548,1,2031
23:06:10,6,991,492,547,1,2031
23:06:11,6,991,487,547,0,2025
23:06:12,6,992,497,548,0,2037
23:06:13,6,992,488,547,1,2028
23:06:14,6,991,490,547,1,2029
23:06:15,6,992,492,547,1,2032
23:06:16,6,992,486,547,1,2026
23:06:17,6,991,488,547,1,2027
23:06:18,6,992,488,547,1,2028
23:06:19,6,992,485,547,1,2025
23:06:20,6,991,483,547,2,2023
23:06:21,6,992,491,547,0,2030
23:06:22,6,0,0,0,0,0
23:06:23,6,992,481,547,2,2022
23:06:24,6,992,484,547,0,2023
23:06:25,6,992,488,546,0,2026
23:06:26,6,991,487,546,0,2024
23:06:27,6,991,492,546,0,2029
23:06:28,6,992,493,547,1,2033
23:06:29,6,991,487,546,0,2024
23:06:30,6,991,491,546,1,2029
23:06:31,6,991,489,546,0,2026
23:06:32,6,991,489,546,1,2027
23:06:33,6,991,492,546,0,2029
23:06:34,6,991,489,546,0,2026
23:06:35,6,991,493,546,1,2031
23:06:36,6,991,488,545,1,2025
23:06:37,6,992,485,545,1,2023
23:06:38,6,991,489,545,0,2025
23:06:39,6,991,489,545,0,2025
23:06:40,6,991,485,544,1,2021
23:06:41,6,991,490,544,1,2026
23:06:42,6,991,489,544,1,2025
23:06:43,6,991,487,544,1,2023
23:06:44,6,992,486,544,1,2023
23:06:45,6,991,489,544,1,2025
23:06:46,6,991,489,544,0,2024
23:06:47,6,992,485,544,1,2022
23:06:48,6,991,490,544,0,2025
23:06:49,6,991,477,544,0,2012
23:06:50,6,991,490,544,0,2025
23:06:51,6,992,489,544,1,2026
23:06:52,6,992,489,544,0,2025
23:06:53,6,992,489,544,1,2026
23:06:54,6,991,487,544,0,2022
23:06:55,6,992,491,544,1,2028
23:06:56,6,992,487,544,1,2024
23:06:57,6,992,484,544,0,2020
23:06:58,6,992,488,544,1,2025
23:06:59,6,992,490,543,0,2025
23:07:00,6,992,491,543,1,2027
23:07:01,6,992,486,543,1,2022
23:07:02,6,992,494,543,1,2030
23:07:03,6,992,488,543,0,2023
23:07:04,6,992,488,543,1,2024
23:07:05,6,994,478,531,0,2003
22:50:41,7,0,0,0,0,0
22:50:42,7,0,0,0,0,0
22:50:43,7,0,0,0,0,0
22:50:44,7,1001,437,532,0,1970
22:50:45,7,0,0,0,0,0
22:50:46,7,1001,481,532,0,2014
22:50:47,7,0,0,0,0,0
22:50:48,7,1001,490,533,0,2024
22:50:49,7,0,0,0,0,0
22:50:50,7,0,0,0,0,0
22:50:51,7,1001,492,532,0,2025
22:50:52,7,0,0,0,0,0
22:50:53,7,0,0,0,0,0
22:50:54,7,0,0,0,0,0
22:50:55,7,1001,489,532,0,2022
22:50:56,7,0,0,0,0,0
22:50:57,7,0,0,0,0,0
22:50:58,7,0,0,0,0,0
22:50:59,7,0,0,0,0,0
22:51:00,7,1001,513,532,0,2046
22:51:01,7,0,0,0,0,0
22:51:02,7,0,0,0,0,0
22:51:03,7,0,0,0,0,0
22:51:04,7,1001,491,532,0,2024
22:51:05,7,0,0,0,0,0
22:51:06,7,0,0,0,0,0
22:51:07,7,0,0,0,0,0
22:51:08,7,0,0,0,0,0
22:51:09,7,0,0,0,0,0
22:51:10,7,0,0,0,0,0
22:51:11,7,0,0,0,0,0
22:51:12,7,1000,477,532,0,2009
22:51:13,7,0,0,0,0,0
22:51:14,7,1001,497,532,0,2030
22:51:15,7,0,0,0,0,0
22:51:16,7,1001,504,533,0,2038
22:51:17,7,1001,505,532,0,2038
22:51:18,7,0,0,0,0,0
22:51:19,7,0,0,0,0,0
22:51:20,7,1000,476,532,0,2008
22:51:21,7,1000,495,532,0,2027
22:51:22,7,0,0,0,0,0
22:51:23,7,1000,480,532,0,2012
22:51:24,7,0,0,0,0,0
22:51:25,7,0,0,0,0,0
22:51:26,7,1001,514,532,0,2047
22:51:27,7,1001,492,532,0,2025
22:51:28,7,0,0,0,0,0
22:51:29,7,0,0,0,0,0
22:51:30,7,0,0,0,0,0
22:51:31,7,1000,489,532,0,2021
22:51:32,7,0,0,0,0,0
22:51:33,7,1001,492,532,0,2025
22:51:34,7,0,0,0,0,0
22:51:35,7,0,0,0,0,0
22:51:36,7,1001,490,532,0,2023
22:51:37,7,0,0,0,0,0
22:51:38,7,0,0,0,0,0
22:51:39,7,1000,494,532,143,2169
22:51:40,7,1000,494,532,100,2126
22:51:41,7,1000,495,532,376,2403
22:51:42,7,1000,484,532,689,2705
22:51:43,7,0,0,0,0,0
22:51:44,7,1000,491,532,510,2533
22:51:45,7,0,0,0,0,0
22:51:46,7,0,0,0,0,0
22:51:47,7,0,0,0,0,0
22:51:48,7,1000,499,532,299,2330
22:51:49,7,0,0,0,0,0
22:51:50,7,1000,460,532,504,2496
22:51:51,7,999,496,532,747,2774
22:51:52,7,0,0,0,0,0
22:51:53,7,0,0,0,0,0
22:51:54,7,0,0,0,0,0
22:51:55,7,0,0,0,0,0
22:51:56,7,0,0,0,0,0
22:51:57,7,1003,491,540,283,2317
22:51:58,7,1003,491,540,427,2461
22:51:59,7,0,0,0,0,0
22:52:00,7,0,0,0,0,0
22:52:01,7,1002,505,560,518,2585
22:52:02,7,0,0,0,0,0
22:52:03,7,0,0,0,0,0
22:52:04,7,0,0,0,0,0
22:52:05,7,0,0,0,0,0
22:52:06,7,0,0,0,0,0
22:52:07,7,1001,463,584,512,2560
22:52:08,7,1001,476,587,564,2628
22:52:09,7,1001,491,589,516,2597
22:52:10,7,1000,494,590,480,2564
22:52:11,7,1000,502,592,688,2782
22:52:12,7,1001,487,595,573,2656
22:52:13,7,1001,493,597,588,2679
22:52:14,7,1001,496,599,455,2551
22:52:15,7,0,0,0,0,0
22:52:16,7,1001,500,602,588,2691
22:52:17,7,0,0,0,0,0
22:52:18,7,0,0,0,0,0
22:52:19,7,1001,527,609,455,2592
22:52:20,7,0,0,0,0,0
22:52:21,7,0,0,0,0,0
22:52:22,7,0,0,0,0,0
22:52:23,7,1000,497,614,414,2525
22:52:24,7,0,0,0,0,0
22:52:25,7,0,0,0,0,0
22:52:26,7,0,0,0,0,0
22:52:27,7,0,0,0,0,0
22:52:28,7,1000,451,619,392,2462
22:52:29,7,1000,518,619,537,2674
22:52:30,7,1000,475,623,422,2520
22:52:31,7,0,0,0,0,0
22:52:32,7,0,0,0,0,0
22:52:33,7,0,0,0,0,0
22:52:34,7,0,0,0,0,0
22:52:35,7,0,0,0,0,0
22:52:36,7,0,0,0,0,0
22:52:37,7,1000,500,631,837,2968
22:52:38,7,1000,499,632,825,2956
22:52:39,7,999,493,632,898,3022
22:52:40,7,0,0,0,0,0
22:52:41,7,0,0,0,0,0
22:52:42,7,0,0,0,0,0
22:52:43,7,1000,486,633,836,2955
22:52:44,7,0,0,0,0,0
22:52:45,7,0,0,0,0,0
22:52:46,7,1000,504,635,754,2893
22:52:47,7,0,0,0,0,0
22:52:48,7,0,0,0,0,0
22:52:49,7,1000,493,636,925,3054
22:52:50,7,999,493,637,984,3113
22:52:51,7,999,499,638,828,2964
22:52:52,7,1000,465,639,933,3037
22:52:53,7,999,498,640,815,2952
22:52:54,7,1000,488,640,904,3032
22:52:55,7,1000,490,641,886,3017
22:52:56,7,1000,494,643,1000,3137
22:52:57,7,998,498,643,835,2974
22:52:58,7,998,490,643,817,2948
22:52:59,7,998,483,643,856,2980
22:53:00,7,999,489,643,885,3016
22:53:01,7,0,0,0,0,0
22:53:02,7,998,502,645,879,3024
22:53:03,7,999,505,646,867,3017
22:53:04,7,999,498,648,804,2949
22:53:05,7,999,473,648,892,3012
22:53:06,7,0,0,0,0,0
22:53:07,7,0,0,0,0,0
22:53:08,7,999,485,653,852,2989
22:53:09,7,999,492,653,892,3036
22:53:10,7,998,498,655,897,3048
22:53:11,7,1000,507,657,920,3084
22:53:12,7,999,489,660,944,3092
22:53:13,7,1000,478,662,888,3028
22:53:14,7,1000,428,665,941,3034
22:53:15,7,999,603,667,956,3225
22:53:16,7,1000,477,670,893,3040
22:53:17,7,999,515,671,934,3119
22:53:18,7,996,501,674,856,3027
22:53:19,7,999,494,675,865,3033
22:53:20,7,998,513,677,913,3101
22:53:21,7,999,493,677,898,3067
22:53:22,7,1000,539,679,838,3056
22:53:23,7,999,501,680,896,3076
22:53:24,7,999,483,681,867,3030
22:53:25,7,0,0,0,0,0
22:53:26,7,999,495,679,876,3049
22:53:27,7,999,512,679,948,3138
22:53:28,7,999,492,680,815,2986
22:53:29,7,0,0,0,0,0
22:53:30,7,999,497,681,883,3060
22:53:31,7,999,556,682,950,3187
22:53:32,7,999,484,682,960,3125
22:53:33,7,999,492,681,813,2985
22:53:34,7,999,495,681,862,3037
22:53:35,7,0,0,0,0,0
22:53:36,7,0,0,0,0,0
22:53:37,7,999,503,681,879,3062
22:53:38,7,1000,482,681,833,2996
22:53:39,7,1000,489,683,826,2998
22:53:40,7,0,0,0,0,0
22:53:41,7,999,495,686,855,3035
22:53:42,7,999,489,687,922,3097
22:53:43,7,999,523,689,921,3132
22:53:44,7,0,0,0,0,0
22:53:45,7,0,0,0,0,0
22:53:46,7,0,0,0,0,0
22:53:47,7,998,499,694,943,3134
22:53:48,7,0,0,0,0,0
22:53:49,7,999,482,694,908,3083
22:53:50,7,0,0,0,0,0
22:53:51,7,0,0,0,0,0
22:53:52,7,999,505,692,834,3030
22:53:53,7,0,0,0,0,0
22:53:54,7,999,488,688,904,3079
22:53:55,7,999,491,688,844,3022
22:53:56,7,0,0,0,0,0
22:53:57,7,999,477,686,831,2993
22:53:58,7,999,511,686,778,2974
22:53:59,7,999,479,686,851,3015
22:54:00,7,999,493,685,898,3075
22:54:01,7,999,493,685,882,3059
22:54:02,7,999,474,685,829,2987
22:54:03,7,0,0,0,0,0
22:54:04,7,999,492,685,829,3005
22:54:05,7,999,505,685,888,3077
22:54:06,7,999,483,685,931,3098
22:54:07,7,999,492,683,826,3000
22:54:08,7,999,487,683,835,3004
22:54:09,7,0,0,0,0,0
22:54:10,7,999,490,683,921,3093
22:54:11,7,998,499,683,850,3030
22:54:12,7,998,501,682,869,3050
22:54:13,7,998,494,682,869,3043
22:54:14,7,999,499,682,958,3138
22:54:15,7,999,496,685,837,3017
22:54:16,7,0,0,0,0,0
22:54:17,7,999,472,686,764,2921
22:54:18,7,999,477,688,981,3145
22:54:19,7,0,0,0,0,0
22:54:20,7,1001,494,690,907,3092
22:54:21,7,999,493,690,800,2982
22:54:22,7,0,0,0,0,0
22:54:23,7,0,0,0,0,0
22:54:24,7,999,510,691,984,3184
22:54:25,7,0,0,0,0,0
22:54:26,7,0,0,0,0,0
22:54:27,7,1000,482,693,848,3023
22:54:28,7,999,496,692,839,3026
22:54:29,7,999,501,692,865,3057
22:54:30,7,0,0,0,0,0
22:54:31,7,0,0,0,0,0
22:54:32,7,999,491,694,902,3086
22:54:33,7,0,0,0,0,0
22:54:34,7,0,0,0,0,0
22:54:35,7,998,502,694,794,2988
22:54:36,7,999,491,694,905,3089
22:54:37,7,0,0,0,0,0
22:54:38,7,999,492,694,820,3005
22:54:39,7,999,494,694,906,3093
22:54:40,7,998,505,693,860,3056
22:54:41,7,998,503,693,782,2976
22:54:42,7,999,486,693,844,3022
22:54:43,7,999,502,693,857,3051
22:54:44,7,999,487,694,838,3018
22:54:45,7,999,494,693,923,3109
22:54:46,7,999,491,694,837,3021
22:54:47,7,999,490,694,870,3053
22:54:48,7,998,496,695,893,3082
22:54:49,7,999,496,695,864,3054
22:54:50,7,0,0,0,0,0
22:54:51,7,999,494,693,904,3090
22:54:52,7,0,0,0,0,0
22:54:53,7,999,491,693,957,3140
22:54:54,7,999,495,693,884,3071
22:54:55,7,998,491,693,811,2993
22:54:56,7,999,494,692,779,2964
22:54:57,7,999,504,692,862,3057
22:54:58,7,999,494,693,864,3050
22:54:59,7,998,498,694,867,3057
22:55:00,7,999,499,694,891,3083
22:55:01,7,999,493,694,885,3071
22:55:02,7,999,501,693,874,3067
22:55:03,7,999,498,692,859,3048
22:55:04,7,999,488,692,894,3073
22:55:05,7,999,496,692,857,3044
22:55:06,7,999,487,691,797,2974
22:55:07,7,0,0,0,0,0
22:55:08,7,998,492,690,839,3019
22:55:09,7,998,492,691,791,2972
22:55:10,7,999,484,688,879,3050
22:55:11,7,999,493,687,909,3088
22:55:12,7,999,481,684,852,3016
22:55:13,7,999,487,684,920,3090
22:55:14,7,999,494,683,880,3056
22:55:15,7,999,494,683,909,3085
22:55:16,7,999,456,682,920,3057
22:55:17,7,999,497,682,834,3012
22:55:18,7,999,483,681,884,3047
22:55:19,7,999,506,678,858,3041
22:55:20,7,999,499,678,866,3042
22:55:21,7,1000,497,678,853,3028
22:55:22,7,999,413,678,914,3004
22:55:23,7,1000,507,677,865,3049
22:55:24,7,999,492,676,947,3114
22:55:25,7,1000,489,677,885,3051
22:55:26,7,1000,494,677,860,3031
22:55:27,7,1000,508,677,828,3013
22:55:28,7,0,0,0,0,0
22:55:29,7,999,490,676,883,3048
22:55:30,7,999,498,675,888,3060
22:55:31,7,999,509,675,953,3136
22:55:32,7,999,488,673,899,3059
22:55:33,7,999,500,673,939,3111
22:55:34,7,999,487,672,926,3084
22:55:35,7,1000,476,672,839,2987
22:55:36,7,0,0,0,0,0
22:55:37,7,999,482,672,819,2972
22:55:38,7,999,493,671,901,3064
22:55:39,7,999,486,671,847,3003
22:55:40,7,1000,485,670,848,3003
22:55:41,7,999,486,670,978,3133
22:55:42,7,0,0,0,0,0
22:55:43,7,1000,482,669,910,3061
22:55:44,7,1000,492,668,958,3118
22:55:45,7,999,485,668,961,3113
22:55:46,7,999,488,667,887,3041
22:55:47,7,999,497,667,840,3003
22:55:48,7,1000,497,666,896,3059
22:55:49,7,999,499,666,898,3062
22:55:50,7,999,494,666,871,3030
22:55:51,7,0,0,0,0,0
22:55:52,7,999,492,664,893,3048
22:55:53,7,999,494,664,858,3015
22:55:54,7,999,490,664,881,3034
22:55:55,7,1000,498,663,829,2990
22:55:56,7,999,486,662,880,3027
22:55:57,7,1000,490,661,883,3034
22:55:58,7,1000,474,661,896,3031
22:55:59,7,999,489,660,907,3055
22:56:00,7,999,486,659,920,3064
22:56:01,7,999,503,658,846,3006
22:56:02,7,1000,493,658,885,3036
22:56:03,7,1000,496,657,808,2961
22:56:04,7,1000,496,657,930,3083
22:56:05,7,999,487,656,850,2992
22:56:06,7,999,496,655,865,3015
22:56:07,7,1000,497,656,974,3127
22:56:08,7,1000,484,655,893,3032
22:56:09,7,1000,487,654,791,2932
22:56:10,7,999,493,653,863,3008
22:56:11,7,999,487,653,913,3052
22:56:12,7,999,486,652,877,3014
22:56:13,7,998,493,650,876,3017
22:56:14,7,999,500,650,953,3102
22:56:15,7,999,499,649,912,3059
22:56:16,7,998,483,649,955,3085
22:56:17,7,998,497,648,898,3041
22:56:18,7,998,493,648,464,2603
22:56:19,7,998,494,647,578,2717
22:56:20,7,998,497,647,478,2620
22:56:21,7,998,499,648,637,2782
22:56:22,7,998,479,648,466,2591
22:56:23,7,998,494,648,570,2710
22:56:24,7,998,505,649,434,2586
22:56:25,7,998,504,650,481,2633
22:56:26,7,998,489,650,725,2862
22:56:27,7,998,496,651,423,2568
22:56:28,7,998,488,652,515,2653
22:56:29,7,998,480,652,737,2867
22:56:30,7,998,494,652,790,2934
22:56:31,7,998,483,652,460,2593
22:56:32,7,998,512,652,500,2662
22:56:33,7,998,513,653,495,2659
22:56:34,7,998,490,653,454,2595
22:56:35,7,998,497,653,587,2735
22:56:36,7,999,481,652,457,2589
22:56:37,7,999,497,651,446,2593
22:56:38,7,0,0,0,0,0
22:56:39,7,999,482,651,478,2610
22:56:40,7,1000,484,650,512,2646
22:56:41,7,999,500,651,614,2764
22:56:42,7,999,492,651,661,2803
22:56:43,7,999,494,650,530,2673
22:56:44,7,998,490,651,487,2626
22:56:45,7,998,503,651,438,2590
22:56:46,7,998,489,651,625,2763
22:56:47,7,998,493,651,387,2529
22:56:48,7,998,495,652,524,2669
22:56:49,7,998,494,653,531,2676
22:56:50,7,998,492,653,717,2860
22:56:51,7,999,501,654,545,2699
22:56:52,7,998,492,655,549,2694
22:56:53,7,999,490,654,494,2637
22:56:54,7,998,491,655,479,2623
22:56:55,7,998,489,655,532,2674
22:56:56,7,999,482,656,394,2531
22:56:57,7,998,494,656,589,2737
22:56:58,7,997,497,658,484,2636
22:56:59,7,0,0,0,0,0
22:57:00,7,998,489,658,891,3036
22:57:01,7,998,486,658,878,3020
22:57:02,7,998,496,659,895,3048
22:57:03,7,998,499,659,888,3044
22:57:04,7,999,502,659,937,3097
22:57:05,7,999,491,658,999,3147
22:57:06,7,999,497,657,887,3040
22:57:07,7,999,502,656,902,3059
22:57:08,7,0,0,0,0,0
22:57:09,7,1000,500,657,883,3040
22:57:10,7,999,499,658,882,3038
22:57:11,7,0,0,0,0,0
22:57:12,7,999,497,659,953,3108
22:57:13,7,0,0,0,0,0
22:57:14,7,999,495,659,892,3045
22:57:15,7,999,496,658,866,3019
22:57:16,7,999,494,658,994,3145
22:57:17,7,999,492,656,945,3092
22:57:18,7,999,493,655,890,3037
22:57:19,7,0,0,0,0,0
22:57:20,7,1000,488,655,529,2672
22:57:21,7,1000,496,655,500,2651
22:57:22,7,999,492,654,378,2523
22:57:23,7,999,491,654,399,2543
22:57:24,7,0,0,0,0,0
22:57:25,7,0,0,0,0,0
22:57:26,7,0,0,0,0,0
22:57:27,7,0,0,0,0,0
22:57:28,7,0,0,0,0,0
22:57:29,7,0,0,0,0,0
22:57:30,7,0,0,0,0,0
22:57:31,7,0,0,0,0,0
22:57:32,7,0,0,0,0,0
22:57:33,7,0,0,0,0,0
22:57:34,7,0,0,0,0,0
22:57:35,7,999,492,647,448,2586
22:57:36,7,999,490,646,525,2660
22:57:37,7,999,496,646,473,2614
22:57:38,7,999,490,645,481,2615
22:57:39,7,999,506,646,278,2429
22:57:40,7,999,499,646,474,2618
22:57:41,7,999,487,645,399,2530
22:57:42,7,999,487,644,557,2687
22:57:43,7,999,511,645,498,2653
22:57:44,7,999,514,645,577,2735
22:57:45,7,999,491,645,560,2695
22:57:46,7,1000,493,644,456,2593
22:57:47,7,999,496,644,560,2699
22:57:48,7,999,492,644,517,2652
22:57:49,7,999,495,643,454,2591
22:57:50,7,0,0,0,0,0
22:57:51,7,999,495,644,425,2563
22:57:52,7,999,496,644,419,2558
22:57:53,7,0,0,0,0,0
22:57:54,7,999,492,641,484,2616
22:57:55,7,999,490,641,523,2653
22:57:56,7,1000,495,639,650,2784
22:57:57,7,999,504,638,473,2614
22:57:58,7,999,491,636,471,2597
22:57:59,7,999,495,634,513,2641
22:58:00,7,999,489,633,554,2675
22:58:01,7,999,489,631,545,2664
22:58:02,7,1000,511,630,841,2982
22:58:03,7,1000,483,629,899,3011
22:58:04,7,999,496,627,913,3035
22:58:05,7,998,490,627,906,3021
22:58:06,7,998,495,626,899,3018
22:58:07,7,998,535,625,825,2983
22:58:08,7,999,507,624,896,3026
22:58:09,7,998,478,624,893,2993
22:58:10,7,998,497,624,874,2993
22:58:11,7,998,495,624,898,3015
22:58:12,7,998,480,624,817,2919
22:58:13,7,998,494,624,914,3030
22:58:14,7,998,500,624,890,3012
22:58:15,7,997,482,624,976,3079
22:58:16,7,997,484,624,862,2967
22:58:17,7,997,498,626,843,2964
22:58:18,7,997,492,627,887,3003
22:58:19,7,997,499,627,909,3032
22:58:20,7,997,498,627,827,2949
22:58:21,7,998,492,629,890,3009
22:58:22,7,998,499,630,970,3097
22:58:23,7,998,494,630,870,2992
22:58:24,7,998,482,629,953,3062
22:58:25,7,998,494,630,911,3033
22:58:26,7,997,490,631,879,2997
22:58:27,7,999,496,631,880,3006
22:58:28,7,999,500,631,914,3044
22:58:29,7,0,0,0,0,0
22:58:30,7,999,494,629,946,3068
22:58:31,7,999,496,629,930,3054
22:58:32,7,999,491,629,957,3076
22:58:33,7,999,497,629,901,3026
22:58:34,7,999,493,628,899,3019
22:58:35,7,0,0,0,0,0
22:58:36,7,999,494,625,521,2639
22:58:37,7,999,481,625,620,2725
22:58:38,7,999,484,624,292,2399
22:58:39,7,999,496,623,609,2727
22:58:40,7,999,494,623,444,2560
22:58:41,7,998,496,623,525,2642
22:58:42,7,998,496,622,435,2551
22:58:43,7,999,494,622,588,2703
22:58:44,7,999,488,621,473,2581
22:58:45,7,999,496,621,606,2722
22:58:46,7,1000,497,620,611,2728
22:58:47,7,999,497,620,590,2706
22:58:48,7,999,493,620,507,2619
22:58:49,7,999,495,620,383,2497
22:58:50,7,999,496,620,582,2697
22:58:51,7,999,503,619,631,2752
22:58:52,7,999,489,619,553,2660
22:58:53,7,999,496,619,913,3027
22:58:54,7,999,487,620,901,3007
22:58:55,7,999,491,621,887,2998
22:58:56,7,998,495,622,953,3068
22:58:57,7,998,487,624,975,3084
22:58:58,7,1000,475,627,883,2985
22:58:59,7,999,497,628,833,2957
22:59:00,7,999,493,629,888,3009
22:59:01,7,999,490,630,912,3031
22:59:02,7,0,0,0,0,0
22:59:03,7,998,494,632,889,3013
22:59:04,7,998,494,635,848,2975
22:59:05,7,999,497,635,898,3029
22:59:06,7,998,497,636,904,3035
22:59:07,7,998,490,636,938,3062
22:59:08,7,999,489,636,842,2966
22:59:09,7,999,496,636,933,3064
22:59:10,7,998,496,637,880,3011
22:59:11,7,999,497,637,935,3068
22:59:12,7,999,493,636,916,3044
22:59:13,7,999,488,635,968,3090
22:59:14,7,999,492,635,881,3007
22:59:15,7,998,489,635,926,3048
22:59:16,7,998,498,634,897,3027
22:59:17,7,999,494,634,872,2999
22:59:18,7,999,488,633,914,3034
22:59:19,7,0,0,0,0,0
22:59:20,7,1000,488,632,905,3025
22:59:21,7,999,492,631,894,3016
22:59:22,7,999,497,631,905,3032
22:59:23,7,999,489,630,875,2993
22:59:24,7,999,491,630,917,3037
22:59:25,7,999,467,630,949,3045
22:59:26,7,998,499,630,880,3007
22:59:27,7,998,483,630,947,3058
22:59:28,7,998,507,630,839,2974
22:59:29,7,999,491,630,914,3034
22:59:30,7,999,496,630,875,3000
22:59:31,7,999,501,629,996,3125
22:59:32,7,999,496,628,876,2999
22:59:33,7,999,500,626,937,3062
22:59:34,7,999,484,623,941,3047
22:59:35,7,999,486,623,908,3016
22:59:36,7,999,499,622,852,2972
22:59:37,7,998,494,621,971,3084
22:59:38,7,999,446,620,854,2919
22:59:39,7,999,486,619,915,3019
22:59:40,7,999,483,618,996,3096
22:59:41,7,999,494,616,918,3027
22:59:42,7,998,497,615,895,3005
22:59:43,7,999,486,615,845,2945
22:59:44,7,999,543,614,872,3028
22:59:45,7,999,481,613,902,2995
22:59:46,7,999,502,612,950,3063
22:59:47,7,1000,493,612,928,3033
22:59:48,7,999,485,610,850,2944
22:59:49,7,999,490,610,990,3089
22:59:50,7,999,501,609,876,2985
22:59:51,7,999,509,609,916,3033
22:59:52,7,999,491,609,918,3017
22:59:53,7,999,491,607,910,3007
22:59:54,7,0,0,0,0,0
22:59:55,7,999,488,607,948,3042
22:59:56,7,999,515,606,904,3024
22:59:57,7,999,490,605,960,3054
22:59:58,7,1000,490,605,857,2952
22:59:59,7,998,494,604,875,2971
23:00:00,7,998,493,604,930,3025
23:00:01,7,998,513,605,902,3018
23:00:02,7,998,491,605,930,3024
23:00:03,7,998,503,604,871,2976
23:00:04,7,998,493,605,886,2982
23:00:05,7,998,499,604,920,3021
23:00:06,7,998,489,604,899,2990
23:00:07,7,998,484,605,836,2923
23:00:08,7,998,483,604,890,2975
23:00:09,7,998,504,604,888,2994
23:00:10,7,998,493,605,929,3025
23:00:11,7,999,519,605,869,2992
23:00:12,7,998,495,605,936,3034
23:00:13,7,0,0,0,0,0
23:00:14,7,0,0,0,0,0
23:00:15,7,0,0,0,0,0
23:00:16,7,1000,499,606,884,2989
23:00:17,7,0,0,0,0,0
23:00:18,7,999,489,605,917,3010
23:00:19,7,0,0,0,0,0
23:00:20,7,999,497,606,817,2919
23:00:21,7,999,495,605,955,3054
23:00:22,7,0,0,0,0,0
23:00:23,7,999,464,605,939,3007
23:00:24,7,0,0,0,0,0
23:00:25,7,0,0,0,0,0
23:00:26,7,999,522,604,864,2989
23:00:27,7,0,0,0,0,0
23:00:28,7,0,0,0,0,0
23:00:29,7,0,0,0,0,0
23:00:30,7,0,0,0,0,0
23:00:31,7,999,482,604,916,3001
23:00:32,7,1000,493,604,895,2992
23:00:33,7,1000,499,604,944,3047
23:00:34,7,0,0,0,0,0
23:00:35,7,0,0,0,0,0
23:00:36,7,0,0,0,0,0
23:00:37,7,0,0,0,0,0
23:00:38,7,1000,503,603,972,3078
23:00:39,7,1000,498,602,952,3052
23:00:40,7,0,0,0,0,0
23:00:41,7,999,491,602,951,3043
23:00:42,7,1000,489,602,955,3046
23:00:43,7,1000,476,602,939,3017
23:00:44,7,1000,489,602,939,3030
23:00:45,7,0,0,0,0,0
23:00:46,7,1000,492,601,940,3033
23:00:47,7,1000,495,601,941,3037
23:00:48,7,1000,495,600,962,3057
23:00:49,7,1000,499,600,969,3068
23:00:50,7,1000,472,599,933,3004
23:00:51,7,999,490,599,971,3059
23:00:52,7,0,0,0,0,0
23:00:53,7,999,487,599,947,3032
23:00:54,7,999,493,598,921,3011
23:00:55,7,1000,495,599,951,3045
23:00:56,7,0,0,0,0,0
23:00:57,7,1000,497,599,903,2999
23:00:58,7,1000,503,600,125,2228
23:00:59,7,1000,497,599,119,2215
23:01:00,7,1000,459,599,28,2086
23:01:01,7,1000,497,599,188,2284
23:01:02,7,1000,490,599,64,2153
23:01:03,7,0,0,0,0,0
23:01:04,7,0,0,0,0,0
23:01:05,7,1000,518,599,198,2315
23:01:06,7,0,0,0,0,0
23:01:07,7,999,488,599,143,2229
23:01:08,7,1000,516,599,107,2222
23:01:09,7,999,506,599,111,2215
23:01:10,7,0,0,0,0,0
23:01:11,7,1000,507,599,91,2197
23:01:12,7,1000,527,599,241,2367
23:01:13,7,0,0,0,0,0
23:01:14,7,0,0,0,0,0
23:01:15,7,1000,499,599,78,2176
23:01:16,7,0,0,0,0,0
23:01:17,7,0,0,0,0,0
23:01:18,7,1000,512,599,132,2243
23:01:19,7,1000,475,599,0,2074
23:01:20,7,0,0,0,0,0
23:01:21,7,0,0,0,0,0
23:01:22,7,1000,516,598,2,2116
23:01:23,7,1001,498,598,1,2098
23:01:24,7,1000,494,597,4,2095
23:01:25,7,0,0,0,0,0
23:01:26,7,1000,510,597,2,2109
23:01:27,7,0,0,0,0,0
23:01:28,7,0,0,0,0,0
23:01:29,7,0,0,0,0,0
23:01:30,7,0,0,0,0,0
23:01:31,7,1000,491,596,3,2090
23:01:32,7,0,0,0,0,0
23:01:33,7,1000,433,595,1,2029
23:01:34,7,1000,487,594,2,2083
23:01:35,7,1000,496,594,0,2090
23:01:36,7,1000,480,593,3,2076
23:01:37,7,1001,494,593,1,2089
23:01:38,7,1001,510,593,2,2106
23:01:39,7,0,0,0,0,0
23:01:40,7,1000,514,592,1,2107
23:01:41,7,999,516,592,0,2107
23:01:42,7,0,0,0,0,0
23:01:43,7,1000,443,591,2,2036
23:01:44,7,1000,491,591,2,2084
23:01:45,7,999,514,591,1,2105
23:01:46,7,0,0,0,0,0
23:01:47,7,0,0,0,0,0
23:01:48,7,1000,501,591,4,2096
23:01:49,7,1000,540,590,1,2131
23:01:50,7,1000,471,590,4,2065
23:01:51,7,1000,439,590,5,2034
23:01:52,7,1000,499,590,1,2090
23:01:53,7,999,493,590,1,2083
23:01:54,7,0,0,0,0,0
23:01:55,7,0,0,0,0,0
23:01:56,7,1000,437,589,0,2026
23:01:57,7,0,0,0,0,0
23:01:58,7,1000,485,588,0,2073
23:01:59,7,0,0,0,0,0
23:02:00,7,0,0,0,0,0
23:02:01,7,1000,484,587,1,2072
23:02:02,7,1000,494,587,1,2082
23:02:03,7,1000,469,587,1,2057
23:02:04,7,1001,464,587,1,2053
23:02:05,7,0,0,0,0,0
23:02:06,7,0,0,0,0,0
23:02:07,7,1001,473,586,0,2060
23:02:08,7,1000,522,586,1,2109
23:02:09,7,0,0,0,0,0
23:02:10,7,0,0,0,0,0
23:02:11,7,0,0,0,0,0
23:02:12,7,1000,498,582,0,2080
23:02:13,7,1000,478,582,1,2061
23:02:14,7,1000,505,580,1,2086
23:02:15,7,1001,475,580,2,2058
23:02:16,7,1001,509,579,1,2090
23:02:17,7,1001,492,578,1,2072
23:02:18,7,1001,498,573,1,2073
23:02:19,7,1000,501,558,1,2060
23:02:20,7,1001,498,549,2,2050
23:02:21,7,1001,484,541,1,2027
23:02:22,7,1000,495,543,1,2039
23:02:23,7,1001,509,544,0,2054
23:02:24,7,0,0,0,0,0
23:02:25,7,1001,500,542,1,2044
23:02:26,7,0,0,0,0,0
23:02:27,7,0,0,0,0,0
23:02:28,7,0,0,0,0,0
23:02:29,7,1000,497,539,0,2036
23:02:30,7,0,0,0,0,0
23:02:31,7,0,0,0,0,0
23:02:32,7,1001,504,542,1,2048
23:02:33,7,0,0,0,0,0
23:02:34,7,1001,492,539,1,2033
23:02:35,7,1001,486,538,1,2026
23:02:36,7,1002,490,537,1,2030
23:02:37,7,1001,492,536,1,2030
23:02:38,7,0,0,0,0,0
23:02:39,7,0,0,0,0,0
23:02:40,7,1002,502,533,1,2038
23:02:41,7,0,0,0,0,0
23:02:42,7,1002,490,533,1,2026
23:02:43,7,1002,495,533,1,2031
23:02:44,7,1000,501,532,1,2034
23:02:45,7,1001,503,531,1,2036
23:02:46,7,1001,482,530,1,2014
23:02:47,7,0,0,0,0,0
23:02:48,7,0,0,0,0,0
23:02:49,7,1001,500,532,1,2034
23:02:50,7,1000,495,533,0,2028
23:02:51,7,0,0,0,0,0
23:02:52,7,0,0,0,0,0
23:02:53,7,1001,490,532,2,2025
23:02:54,7,0,0,0,0,0
23:02:55,7,999,401,530,0,1930
23:02:56,7,0,0,0,0,0
23:02:57,7,1000,499,530,0,2029
23:02:58,7,0,0,0,0,0
23:02:59,7,1000,497,532,2,2031
23:03:00,7,0,0,0,0,0
23:03:01,7,1001,507,531,0,2039
23:03:02,7,999,391,530,0,1920
23:03:03,7,999,495,529,0,2023
23:03:04,7,0,0,0,0,0
23:03:05,7,0,0,0,0,0
23:03:06,7,0,0,0,0,0
23:03:07,7,0,0,0,0,0
23:03:08,7,0,0,0,0,0
23:03:09,7,0,0,0,0,0
23:03:10,7,1000,495,530,1,2026
23:03:11,7,1001,494,531,0,2026
23:03:12,7,0,0,0,0,0
23:03:13,7,1001,506,533,1,2041
23:03:14,7,0,0,0,0,0
23:03:15,7,0,0,0,0,0
23:03:16,7,0,0,0,0,0
23:03:17,7,0,0,0,0,0
23:03:18,7,0,0,0,0,0
23:03:19,7,1000,498,531,0,2029
23:03:20,7,0,0,0,0,0
23:03:21,7,1000,489,532,1,2022
23:03:22,7,0,0,0,0,0
23:03:23,7,1001,504,532,1,2038
23:03:24,7,1001,494,532,1,2028
23:03:25,7,0,0,0,0,0
23:03:26,7,0,0,0,0,0
23:03:27,7,0,0,0,0,0
23:03:28,7,1001,490,533,1,2025
23:03:29,7,0,0,0,0,0
23:03:30,7,1001,498,533,1,2033
23:03:31,7,0,0,0,0,0
23:03:32,7,1001,497,533,0,2031
23:03:33,7,0,0,0,0,0
23:03:34,7,1000,497,533,1,2031
23:03:35,7,1000,498,533,1,2032
23:03:36,7,0,0,0,0,0
23:03:37,7,0,0,0,0,0
23:03:38,7,999,498,533,1,2031
23:03:39,7,999,502,533,1,2035
23:03:40,7,999,498,532,1,2030
23:03:41,7,999,496,532,1,2028
23:03:42,7,999,497,532,1,2029
23:03:43,7,0,0,0,0,0
23:03:44,7,0,0,0,0,0
23:03:45,7,998,501,533,2,2034
23:03:46,7,998,500,533,0,2031
23:03:47,7,0,0,0,0,0
23:03:48,7,998,498,533,0,2029
23:03:49,7,0,0,0,0,0
23:03:50,7,0,0,0,0,0
23:03:51,7,0,0,0,0,0
23:03:52,7,0,0,0,0,0
23:03:53,7,0,0,0,0,0
23:03:54,7,998,503,539,0,2040
23:03:55,7,998,504,540,1,2043
23:03:56,7,0,0,0,0,0
23:03:57,7,0,0,0,0,0
23:03:58,7,998,492,540,1,2031
23:03:59,7,1000,496,540,2,2038
23:04:00,7,0,0,0,0,0
23:04:01,7,999,493,540,2,2034
23:04:02,7,0,0,0,0,0
23:04:03,7,0,0,0,0,0
23:04:04,7,1000,493,540,1,2034
23:04:05,7,0,0,0,0,0
23:04:06,7,1000,497,540,1,2038
23:04:07,7,1000,496,539,2,2037
23:04:08,7,1000,493,539,1,2033
23:04:09,7,1000,495,539,2,2036
23:04:10,7,0,0,0,0,0
23:04:11,7,0,0,0,0,0
23:04:12,7,1000,495,539,0,2034
23:04:13,7,1000,493,539,1,2033
23:04:14,7,0,0,0,0,0
23:04:15,7,1000,498,539,1,2038
23:04:16,7,1000,496,539,1,2036
23:04:17,7,1000,495,539,1,2035
23:04:18,7,0,0,0,0,0
23:04:19,7,0,0,0,0,0
23:04:20,7,999,500,538,2,2039
23:04:21,7,1000,500,538,2,2040
23:04:22,7,0,0,0,0,0
23:04:23,7,1000,495,539,0,2034
23:04:24,7,0,0,0,0,0
23:04:25,7,0,0,0,0,0
23:04:26,7,1000,493,538,1,2032
23:04:27,7,999,497,538,1,2035
23:04:28,7,1000,497,538,2,2037
23:04:29,7,1000,502,539,1,2042
23:04:30,7,0,0,0,0,0
23:04:31,7,0,0,0,0,0
23:04:32,7,999,492,538,0,2029
23:04:33,7,0,0,0,0,0
23:04:34,7,999,492,538,1,2030
23:04:35,7,999,492,538,0,2029
23:04:36,7,999,499,538,1,2037
23:04:37,7,0,0,0,0,0
23:04:38,7,999,494,538,0,2031
23:04:39,7,999,492,538,0,2029
23:04:40,7,1000,490,538,1,2029
23:04:41,7,999,499,538,0,2036
23:04:42,7,1000,499,538,1,2038
23:04:43,7,1000,488,538,1,2027
23:04:44,7,999,494,538,1,2032
23:04:45,7,1000,494,538,1,2033
23:04:46,7,1000,490,538,1,2029
23:04:47,7,999,502,538,1,2040
23:04:48,7,999,503,538,2,2042
23:04:49,7,0,0,0,0,0
23:04:50,7,1000,500,538,1,2039
23:04:51,7,0,0,0,0,0
23:04:52,7,0,0,0,0,0
23:04:53,7,999,487,538,1,2025
23:04:54,7,0,0,0,0,0
23:04:55,7,0,0,0,0,0
23:04:56,7,1000,502,538,2,2042
23:04:57,7,0,0,0,0,0
23:04:58,7,999,497,538,0,2034
23:04:59,7,0,0,0,0,0
23:05:00,7,0,0,0,0,0
23:05:01,7,0,0,0,0,0
23:05:02,7,1000,494,538,1,2033
23:05:03,7,1000,489,538,1,2028
23:05:04,7,1001,493,538,1,2033
23:05:05,7,1000,493,538,0,2031
23:05:06,7,0,0,0,0,0
23:05:07,7,999,500,538,1,2038
23:05:08,7,999,491,539,1,2030
23:05:09,7,999,493,539,0,2031
23:05:10,7,999,492,539,1,2031
23:05:11,7,1000,495,539,1,2035
23:05:12,7,999,487,539,1,2026
23:05:13,7,999,496,539,0,2034
23:05:14,7,1000,499,539,0,2038
23:05:15,7,1000,496,539,1,2036
23:05:16,7,999,497,539,0,2035
23:05:17,7,999,493,539,1,2032
23:05:18,7,999,498,539,1,2037
23:05:19,7,1000,493,539,2,2034
23:05:20,7,999,496,539,0,2034
23:05:21,7,1000,493,540,0,2033
23:05:22,7,1000,495,540,1,2036
23:05:23,7,999,494,540,0,2033
23:05:24,7,1000,491,540,0,2031
23:05:25,7,999,493,540,0,2032
23:05:26,7,1000,494,540,1,2035
23:05:27,7,1000,498,540,0,2038
23:05:28,7,999,493,540,0,2032
23:05:29,7,1000,497,541,1,2039
23:05:30,7,1000,495,541,1,2037
23:05:31,7,1000,497,540,1,2038
23:05:32,7,1000,495,540,0,2035
23:05:33,7,1000,491,540,1,2032
23:05:34,7,0,0,0,0,0
23:05:35,7,1000,501,540,1,2042
23:05:36,7,1001,497,540,2,2040
23:05:37,7,1000,495,540,2,2037
23:05:38,7,0,0,0,0,0
23:05:39,7,999,488,540,2,2029
23:05:40,7,1000,495,539,1,2035
23:05:41,7,0,0,0,0,0
23:05:42,7,1000,492,539,0,2031
23:05:43,7,1000,494,539,1,2034
23:05:44,7,1000,492,539,2,2033
23:05:45,7,1000,489,539,0,2028
23:05:46,7,0,0,0,0,0
23:05:47,7,1001,492,539,1,2033
23:05:48,7,1001,495,539,0,2035
23:05:49,7,1000,491,539,2,2032
23:05:50,7,1000,498,539,2,2039
23:05:51,7,0,0,0,0,0
23:05:52,7,1001,489,538,1,2029
23:05:53,7,1000,483,538,2,2023
23:05:54,7,1001,495,538,1,2035
23:05:55,7,0,0,0,0,0
23:05:56,7,1001,493,538,0,2032
23:05:57,7,0,0,0,0,0
23:05:58,7,0,0,0,0,0
23:05:59,7,1000,493,538,1,2032
23:06:00,7,0,0,0,0,0
23:06:01,7,0,0,0,0,0
23:06:02,7,999,493,539,1,2032
23:06:03,7,998,497,539,0,2034
23:06:04,7,997,498,539,1,2035
23:06:05,7,998,493,539,2,2032
23:06:06,7,999,494,539,1,2033
23:06:07,7,1000,497,540,1,2038
23:06:08,7,1000,494,539,1,2034
23:06:09,7,1000,484,539,0,2023
23:06:10,7,0,0,0,0,0
23:06:11,7,1000,458,540,2,2000
23:06:12,7,1000,500,540,0,2040
23:06:13,7,1000,498,540,1,2039
23:06:14,7,0,0,0,0,0
23:06:15,7,0,0,0,0,0
23:06:16,7,0,0,0,0,0
23:06:17,7,0,0,0,0,0
23:06:18,7,1001,496,540,2,2039
23:06:19,7,1001,484,540,1,2026
23:06:20,7,1000,492,539,0,2031
23:06:21,7,0,0,0,0,0
23:06:22,7,1000,493,539,1,2033
23:06:23,7,1001,497,539,2,2039
23:06:24,7,1000,498,539,0,2037
23:06:25,7,0,0,0,0,0
23:06:26,7,0,0,0,0,0
23:06:27,7,1001,496,539,0,2036
23:06:28,7,1000,501,540,0,2041
23:06:29,7,1000,484,539,2,2025
23:06:30,7,1000,494,539,0,2033
23:06:31,7,1000,489,539,1,2029
23:06:32,7,1001,491,539,1,2032
23:06:33,7,0,0,0,0,0
23:06:34,7,1000,495,539,1,2035
23:06:35,7,0,0,0,0,0
23:06:36,7,1001,494,539,0,2034
23:06:37,7,1001,495,539,0,2035
23:06:38,7,0,0,0,0,0
23:06:39,7,1001,494,538,1,2034
23:06:40,7,0,0,0,0,0
23:06:41,7,1000,493,539,0,2032
23:06:42,7,1001,496,539,2,2038
23:06:43,7,1000,499,538,2,2039
23:06:44,7,1000,492,538,2,2032
23:06:45,7,1001,491,538,1,2031
23:06:46,7,1001,491,538,1,2031
23:06:47,7,1001,495,538,1,2035
23:06:48,7,1001,491,538,1,2031
23:06:49,7,1001,494,538,1,2034
23:06:50,7,1001,499,538,2,2040
23:06:51,7,1002,496,538,2,2038
23:06:52,7,1001,458,538,2,1999
23:06:53,7,1001,492,538,0,2031
23:06:54,7,1001,487,537,1,2026
23:06:55,7,1001,480,537,0,2018
23:06:56,7,1002,488,537,0,2027
23:06:57,7,1001,499,537,0,2037
23:06:58,7,1001,497,537,1,2036
23:06:59,7,1002,498,537,1,2038
23:07:00,7,1002,491,537,0,2030
23:07:01,7,1002,497,537,0,2036
23:07:02,7,1002,493,537,0,2032
23:07:03,7,1003,486,537,0,2026
23:07:04,7,1002,491,537,1,2031
23:07:05,7,1003,491,491,0,1985
22:50:41,8,0,0,0,0,0
22:50:42,8,0,0,0,0,0
22:50:43,8,0,0,0,0,0
22:50:44,8,0,0,0,0,0
22:50:45,8,0,0,0,0,0
22:50:46,8,0,0,0,0,0
22:50:47,8,0,0,0,0,0
22:50:48,8,1000,513,533,0,2046
22:50:49,8,0,0,0,0,0
22:50:50,8,0,0,0,0,0
22:50:51,8,0,0,0,0,0
22:50:52,8,1001,489,533,0,2023
22:50:53,8,0,0,0,0,0
22:50:54,8,1001,478,533,0,2012
22:50:55,8,1001,496,533,0,2030
22:50:56,8,0,0,0,0,0
22:50:57,8,1001,492,533,0,2026
22:50:58,8,0,0,0,0,0
22:50:59,8,1001,470,533,0,2004
22:51:00,8,0,0,0,0,0
22:51:01,8,0,0,0,0,0
22:51:02,8,0,0,0,0,0
22:51:03,8,1000,485,533,0,2018
22:51:04,8,0,0,0,0,0
22:51:05,8,1000,482,533,0,2015
22:51:06,8,1000,496,533,0,2029
22:51:07,8,1000,494,533,0,2027
22:51:08,8,1000,491,533,0,2024
22:51:09,8,1000,466,533,0,1999
22:51:10,8,1000,491,533,0,2024
22:51:11,8,1001,481,533,0,2015
22:51:12,8,0,0,0,0,0
22:51:13,8,0,0,0,0,0
22:51:14,8,1000,576,533,0,2109
22:51:15,8,0,0,0,0,0
22:51:16,8,0,0,0,0,0
22:51:17,8,0,0,0,0,0
22:51:18,8,1000,490,533,0,2023
22:51:19,8,1000,495,533,0,2028
22:51:20,8,999,484,533,0,2016
22:51:21,8,1000,485,533,0,2018
22:51:22,8,1000,490,533,0,2023
22:51:23,8,999,496,533,0,2028
22:51:24,8,0,0,0,0,0
22:51:25,8,1000,485,533,0,2018
22:51:26,8,1000,480,532,0,2012
22:51:27,8,0,0,0,0,0
22:51:28,8,1000,493,533,0,2026
22:51:29,8,1000,482,533,0,2015
22:51:30,8,0,0,0,0,0
22:51:31,8,1000,502,533,0,2035
22:51:32,8,1000,501,532,0,2033
22:51:33,8,0,0,0,0,0
22:51:34,8,1000,482,532,0,2014
22:51:35,8,0,0,0,0,0
22:51:36,8,1000,493,532,0,2025
22:51:37,8,0,0,0,0,0
22:51:38,8,0,0,0,0,0
22:51:39,8,1000,483,532,45,2060
22:51:40,8,1000,493,532,153,2178
22:51:41,8,0,0,0,0,0
22:51:42,8,0,0,0,0,0
22:51:43,8,999,489,532,527,2547
22:51:44,8,999,495,532,483,2509
22:51:45,8,1000,480,533,287,2300
22:51:46,8,0,0,0,0,0
22:51:47,8,999,485,532,549,2565
22:51:48,8,0,0,0,0,0
22:51:49,8,1000,487,532,541,2560
22:51:50,8,0,0,0,0,0
22:51:51,8,0,0,0,0,0
22:51:52,8,1000,493,532,537,2562
22:51:53,8,0,0,0,0,0
22:51:54,8,1001,492,534,608,2635
22:51:55,8,0,0,0,0,0
22:51:56,8,0,0,0,0,0
22:51:57,8,1001,487,546,451,2485
22:51:58,8,0,0,0,0,0
22:51:59,8,1012,517,765,605,2899
22:52:00,8,1011,499,796,429,2735
22:52:01,8,0,0,0,0,0
22:52:02,8,1008,503,758,510,2779
22:52:03,8,0,0,0,0,0
22:52:04,8,0,0,0,0,0
22:52:05,8,996,491,754,474,2715
22:52:06,8,0,0,0,0,0
22:52:07,8,0,0,0,0,0
22:52:08,8,992,498,758,743,2991
22:52:09,8,991,476,756,690,2913
22:52:10,8,991,493,756,655,2895
22:52:11,8,995,462,753,535,2745
22:52:12,8,988,492,753,481,2714
22:52:13,8,986,497,751,482,2716
22:52:14,8,993,489,752,460,2694
22:52:15,8,997,489,753,462,2701
22:52:16,8,997,496,754,515,2762
22:52:17,8,0,0,0,0,0
22:52:18,8,992,475,767,530,2764
22:52:19,8,0,0,0,0,0
22:52:20,8,985,489,759,473,2706
22:52:21,8,990,480,758,515,2743
22:52:22,8,991,530,762,547,2830
22:52:23,8,991,493,763,459,2706
22:52:24,8,990,475,764,529,2758
22:52:25,8,985,471,763,417,2636
22:52:26,8,990,488,763,462,2703
22:52:27,8,987,494,762,542,2785
22:52:28,8,0,0,0,0,0
22:52:29,8,989,492,772,521,2774
22:52:30,8,991,506,772,615,2884
22:52:31,8,0,0,0,0,0
22:52:32,8,0,0,0,0,0
22:52:33,8,988,481,772,996,3237
22:52:34,8,986,495,772,841,3094
22:52:35,8,985,480,770,951,3186
22:52:36,8,0,0,0,0,0
22:52:37,8,988,504,766,825,3083
22:52:38,8,985,488,767,936,3176
22:52:39,8,995,499,766,860,3120
22:52:40,8,990,493,768,992,3243
22:52:41,8,0,0,0,0,0
22:52:42,8,988,483,764,890,3125
22:52:43,8,988,502,765,878,3133
22:52:44,8,984,487,765,905,3141
22:52:45,8,984,480,765,859,3088
22:52:46,8,983,486,762,916,3147
22:52:47,8,0,0,0,0,0
22:52:48,8,989,496,760,918,3163
22:52:49,8,988,488,760,885,3121
22:52:50,8,0,0,0,0,0
22:52:51,8,986,503,758,784,3031
22:52:52,8,985,480,759,857,3081
22:52:53,8,985,491,759,819,3054
22:52:54,8,985,500,757,807,3049
22:52:55,8,983,501,757,850,3091
22:52:56,8,985,491,756,889,3121
22:52:57,8,983,486,755,982,3206
22:52:58,8,985,504,755,949,3193
22:52:59,8,984,497,752,872,3105
22:53:00,8,986,502,752,896,3136
22:53:01,8,0,0,0,0,0
22:53:02,8,985,487,754,844,3070
22:53:03,8,0,0,0,0,0
22:53:04,8,0,0,0,0,0
22:53:05,8,987,485,754,850,3076
22:53:06,8,984,479,754,918,3135
22:53:07,8,983,495,754,800,3032
22:53:08,8,993,498,755,894,3140
22:53:09,8,0,0,0,0,0
22:53:10,8,997,491,764,851,3103
22:53:11,8,1001,489,767,869,3126
22:53:12,8,998,493,771,997,3259
22:53:13,8,988,488,766,844,3086
22:53:14,8,986,482,763,927,3158
22:53:15,8,0,0,0,0,0
22:53:16,8,984,487,757,870,3098
22:53:17,8,984,497,755,989,3225
22:53:18,8,984,497,752,854,3087
22:53:19,8,0,0,0,0,0
22:53:20,8,0,0,0,0,0
22:53:21,8,984,486,746,861,3077
22:53:22,8,985,487,744,881,3097
22:53:23,8,985,489,744,976,3194
22:53:24,8,985,488,742,947,3162
22:53:25,8,984,504,742,816,3046
22:53:26,8,984,487,741,865,3077
22:53:27,8,984,486,739,839,3048
22:53:28,8,984,482,739,869,3074
22:53:29,8,984,494,737,877,3092
22:53:30,8,984,500,737,907,3128
22:53:31,8,984,483,736,923,3126
22:53:32,8,984,488,735,898,3105
22:53:33,8,984,478,735,889,3086
22:53:34,8,984,492,733,868,3077
22:53:35,8,984,494,733,848,3059
22:53:36,8,984,490,732,862,3068
22:53:37,8,985,491,732,864,3072
22:53:38,8,985,490,732,856,3063
22:53:39,8,984,490,728,957,3159
22:53:40,8,984,513,726,893,3116
22:53:41,8,984,487,725,867,3063
22:53:42,8,984,489,724,874,3071
22:53:43,8,984,488,723,823,3018
22:53:44,8,984,477,722,887,3070
22:53:45,8,984,489,720,913,3106
22:53:46,8,984,488,718,831,3021
22:53:47,8,984,485,717,959,3145
22:53:48,8,985,492,715,903,3095
22:53:49,8,0,0,0,0,0
22:53:50,8,985,485,712,924,3106
22:53:51,8,985,490,712,807,2994
22:53:52,8,985,483,712,879,3059
22:53:53,8,0,0,0,0,0
22:53:54,8,985,482,709,873,3049
22:53:55,8,985,500,709,856,3050
22:53:56,8,985,491,709,854,3039
22:53:57,8,984,486,708,904,3082
22:53:58,8,985,489,708,868,3050
22:53:59,8,985,484,707,900,3076
22:54:00,8,985,488,707,887,3067
22:54:01,8,985,485,706,900,3076
22:54:02,8,984,487,705,823,2999
22:54:03,8,985,483,705,894,3067
22:54:04,8,985,487,704,848,3024
22:54:05,8,984,493,703,890,3070
22:54:06,8,985,489,703,916,3093
22:54:07,8,985,490,703,830,3008
22:54:08,8,985,487,702,916,3090
22:54:09,8,989,496,701,756,2942
22:54:10,8,985,502,699,860,3046
22:54:11,8,985,499,699,879,3062
22:54:12,8,985,492,700,968,3145
22:54:13,8,984,482,698,830,2994
22:54:14,8,0,0,0,0,0
22:54:15,8,984,486,697,781,2948
22:54:16,8,988,487,698,950,3123
22:54:17,8,985,488,698,876,3047
22:54:18,8,985,487,697,889,3058
22:54:19,8,986,496,695,820,2997
22:54:20,8,985,481,694,870,3030
22:54:21,8,985,485,693,840,3003
22:54:22,8,985,488,692,898,3063
22:54:23,8,987,488,691,889,3055
22:54:24,8,987,488,691,893,3059
22:54:25,8,985,494,691,866,3036
22:54:26,8,985,494,690,953,3122
22:54:27,8,985,502,689,938,3114
22:54:28,8,985,490,688,864,3027
22:54:29,8,986,493,686,891,3056
22:54:30,8,985,490,686,871,3032
22:54:31,8,985,489,685,889,3048
22:54:32,8,985,491,685,844,3005
22:54:33,8,985,490,684,859,3018
22:54:34,8,986,481,684,952,3103
22:54:35,8,0,0,0,0,0
22:54:36,8,985,493,682,907,3067
22:54:37,8,985,493,682,904,3064
22:54:38,8,0,0,0,0,0
22:54:39,8,985,491,681,859,3016
22:54:40,8,985,489,681,995,3150
22:54:41,8,0,0,0,0,0
22:54:42,8,0,0,0,0,0
22:54:43,8,985,487,678,886,3036
22:54:44,8,986,484,679,943,3092
22:54:45,8,985,487,678,889,3039
22:54:46,8,0,0,0,0,0
22:54:47,8,0,0,0,0,0
22:54:48,8,985,488,676,800,2949
22:54:49,8,984,494,675,875,3028
22:54:50,8,978,480,674,906,3038
22:54:51,8,947,485,674,903,3009
22:54:52,8,992,487,675,876,3030
22:54:53,8,988,475,679,895,3037
22:54:54,8,983,484,680,872,3019
22:54:55,8,997,491,679,881,3048
22:54:56,8,997,484,678,877,3036
22:54:57,8,998,488,678,886,3050
22:54:58,8,999,490,680,883,3052
22:54:59,8,998,488,680,878,3044
22:55:00,8,999,490,680,868,3037
22:55:01,8,999,488,680,875,3042
22:55:02,8,999,490,680,875,3044
22:55:03,8,999,490,680,878,3047
22:55:04,8,999,488,680,893,3060
22:55:05,8,999,492,680,867,3038
22:55:06,8,999,486,680,860,3025
22:55:07,8,999,490,680,880,3049
22:55:08,8,999,494,681,852,3026
22:55:09,8,999,487,681,869,3036
22:55:10,8,999,488,681,884,3052
22:55:11,8,999,489,681,862,3031
22:55:12,8,999,490,681,906,3076
22:55:13,8,999,490,681,880,3050
22:55:14,8,999,491,682,894,3066
22:55:15,8,999,486,684,878,3047
22:55:16,8,999,492,685,869,3045
22:55:17,8,999,487,685,886,3057
22:55:18,8,999,490,687,862,3038
22:55:19,8,999,492,689,880,3060
22:55:20,8,1000,489,694,893,3076
22:55:21,8,1002,488,700,876,3066
22:55:22,8,1001,481,709,855,3046
22:55:23,8,1002,496,720,893,3111
22:55:24,8,1001,497,741,889,3128
22:55:25,8,999,486,750,886,3121
22:55:26,8,999,486,745,853,3083
22:55:27,8,999,490,749,903,3141
22:55:28,8,998,495,751,850,3094
22:55:29,8,992,492,751,914,3149
22:55:30,8,982,491,746,866,3085
22:55:31,8,996,486,744,900,3126
22:55:32,8,998,487,744,871,3100
22:55:33,8,998,492,743,856,3089
22:55:34,8,998,483,741,889,3111
22:55:35,8,998,494,740,868,3100
22:55:36,8,998,492,738,851,3079
22:55:37,8,998,497,738,867,3100
22:55:38,8,998,493,736,897,3124
22:55:39,8,998,494,735,897,3124
22:55:40,8,998,490,735,909,3132
22:55:41,8,998,489,734,898,3119
22:55:42,8,998,487,733,876,3094
22:55:43,8,998,492,732,863,3085
22:55:44,8,998,489,731,889,3107
22:55:45,8,998,491,730,848,3067
22:55:46,8,998,491,729,844,3062
22:55:47,8,998,488,728,885,3099
22:55:48,8,998,489,727,868,3082
22:55:49,8,998,490,726,844,3058
22:55:50,8,998,485,724,833,3040
22:55:51,8,998,493,723,906,3120
22:55:52,8,998,491,720,864,3073
22:55:53,8,998,487,720,879,3084
22:55:54,8,998,490,718,903,3109
22:55:55,8,998,489,716,883,3086
22:55:56,8,998,490,714,853,3055
22:55:57,8,998,489,713,877,3077
22:55:58,8,998,486,711,879,3074
22:55:59,8,998,493,710,862,3063
22:56:00,8,998,493,709,890,3090
22:56:01,8,998,489,708,855,3050
22:56:02,8,998,488,707,881,3074
22:56:03,8,998,489,706,902,3095
22:56:04,8,998,490,705,876,3069
22:56:05,8,998,488,704,884,3074
22:56:06,8,998,485,703,904,3090
22:56:07,8,998,489,702,830,3019
22:56:08,8,998,493,702,876,3069
22:56:09,8,998,489,701,918,3106
22:56:10,8,998,490,700,859,3047
22:56:11,8,998,493,698,864,3053
22:56:12,8,998,490,697,894,3079
22:56:13,8,998,488,697,874,3057
22:56:14,8,998,486,697,856,3037
22:56:15,8,998,489,696,880,3063
22:56:16,8,998,492,694,871,3055
22:56:17,8,998,489,694,872,3053
22:56:18,8,0,0,0,0,0
22:56:19,8,998,498,693,530,2719
22:56:20,8,999,488,694,421,2602
22:56:21,8,0,0,0,0,0
22:56:22,8,998,488,695,596,2777
22:56:23,8,999,491,696,567,2753
22:56:24,8,998,482,696,658,2834
22:56:25,8,998,492,696,738,2924
22:56:26,8,998,488,695,279,2460
22:56:27,8,999,479,696,599,2773
22:56:28,8,0,0,0,0,0
22:56:29,8,0,0,0,0,0
22:56:30,8,0,0,0,0,0
22:56:31,8,999,485,697,612,2793
22:56:32,8,999,488,697,303,2487
22:56:33,8,0,0,0,0,0
22:56:34,8,998,482,698,483,2661
22:56:35,8,999,493,698,448,2638
22:56:36,8,0,0,0,0,0
22:56:37,8,999,495,695,626,2815
22:56:38,8,999,478,694,772,2943
22:56:39,8,0,0,0,0,0
22:56:40,8,0,0,0,0,0
22:56:41,8,998,492,690,537,2717
22:56:42,8,0,0,0,0,0
22:56:43,8,999,492,689,679,2859
22:56:44,8,0,0,0,0,0
22:56:45,8,999,474,687,746,2906
22:56:46,8,999,496,686,362,2543
22:56:47,8,0,0,0,0,0
22:56:48,8,998,482,688,325,2493
22:56:49,8,0,0,0,0,0
22:56:50,8,999,481,691,452,2623
22:56:51,8,999,490,694,524,2707
22:56:52,8,999,488,695,510,2692
22:56:53,8,998,496,696,701,2891
22:56:54,8,999,495,698,315,2507
22:56:55,8,998,488,699,495,2680
22:56:56,8,0,0,0,0,0
22:56:57,8,998,492,698,571,2759
22:56:58,8,997,488,698,544,2727
22:56:59,8,998,490,697,916,3101
22:57:00,8,998,487,696,887,3068
22:57:01,8,998,489,695,905,3087
22:57:02,8,998,486,694,906,3084
22:57:03,8,998,511,694,875,3078
22:57:04,8,997,493,694,902,3086
22:57:05,8,0,0,0,0,0
22:57:06,8,998,483,694,945,3120
22:57:07,8,998,491,693,968,3150
22:57:08,8,998,518,693,881,3090
22:57:09,8,998,491,694,899,3082
22:57:10,8,998,489,693,855,3035
22:57:11,8,998,488,694,937,3117
22:57:12,8,998,494,693,911,3096
22:57:13,8,0,0,0,0,0
22:57:14,8,998,482,691,972,3143
22:57:15,8,998,488,690,902,3078
22:57:16,8,998,489,687,835,3009
22:57:17,8,999,495,685,930,3109
22:57:18,8,998,489,683,824,2994
22:57:19,8,999,494,680,938,3111
22:57:20,8,998,489,681,474,2642
22:57:21,8,998,490,681,423,2592
22:57:22,8,998,488,679,519,2684
22:57:23,8,998,496,679,625,2798
22:57:24,8,998,488,678,592,2756
22:57:25,8,996,487,678,518,2679
22:57:26,8,996,478,677,356,2507
22:57:27,8,997,487,676,495,2655
22:57:28,8,998,489,674,533,2694
22:57:29,8,997,490,673,351,2511
22:57:30,8,0,0,0,0,0
22:57:31,8,0,0,0,0,0
22:57:32,8,996,493,670,682,2841
22:57:33,8,996,496,669,640,2801
22:57:34,8,997,493,667,566,2723
22:57:35,8,996,491,668,525,2680
22:57:36,8,996,494,668,635,2793
22:57:37,8,996,477,668,486,2627
22:57:38,8,998,509,666,553,2726
22:57:39,8,998,478,667,376,2519
22:57:40,8,996,489,668,469,2622
22:57:41,8,996,483,669,490,2638
22:57:42,8,996,474,672,611,2753
22:57:43,8,998,477,679,671,2825
22:57:44,8,997,489,680,468,2634
22:57:45,8,998,488,678,460,2624
22:57:46,8,998,500,678,476,2652
22:57:47,8,998,455,674,617,2744
22:57:48,8,998,442,674,489,2603
22:57:49,8,998,479,671,653,2801
22:57:50,8,998,483,671,368,2520
22:57:51,8,998,485,670,396,2549
22:57:52,8,999,488,670,360,2517
22:57:53,8,999,491,668,582,2740
22:57:54,8,999,495,665,679,2838
22:57:55,8,998,481,665,563,2707
22:57:56,8,998,482,662,444,2586
22:57:57,8,0,0,0,0,0
22:57:58,8,999,494,661,585,2739
22:57:59,8,998,496,661,606,2761
22:58:00,8,998,496,660,456,2610
22:58:01,8,998,494,660,459,2611
22:58:02,8,998,489,658,922,3067
22:58:03,8,998,489,657,885,3029
22:58:04,8,998,505,657,911,3071
22:58:05,8,998,482,656,918,3054
22:58:06,8,999,500,656,900,3055
22:58:07,8,998,487,654,866,3005
22:58:08,8,998,486,653,894,3031
22:58:09,8,998,496,653,888,3035
22:58:10,8,998,500,656,870,3024
22:58:11,8,998,493,658,957,3106
22:58:12,8,0,0,0,0,0
22:58:13,8,0,0,0,0,0
22:58:14,8,998,492,655,965,3110
22:58:15,8,0,0,0,0,0
22:58:16,8,998,487,655,993,3133
22:58:17,8,998,494,655,854,3001
22:58:18,8,998,489,655,879,3021
22:58:19,8,0,0,0,0,0
22:58:20,8,0,0,0,0,0
22:58:21,8,998,490,655,986,3129
22:58:22,8,999,492,653,859,3003
22:58:23,8,0,0,0,0,0
22:58:24,8,0,0,0,0,0
22:58:25,8,998,490,653,858,2999
22:58:26,8,998,489,652,902,3041
22:58:27,8,0,0,0,0,0
22:58:28,8,999,493,651,835,2978
22:58:29,8,998,493,649,853,2993
22:58:30,8,999,484,650,825,2958
22:58:31,8,999,495,649,871,3014
22:58:32,8,998,493,648,893,3032
22:58:33,8,998,480,647,851,2976
22:58:34,8,0,0,0,0,0
22:58:35,8,999,481,646,795,2921
22:58:36,8,999,489,645,429,2562
22:58:37,8,999,511,645,349,2504
22:58:38,8,999,499,644,595,2737
22:58:39,8,999,495,643,490,2627
22:58:40,8,999,490,642,539,2670
22:58:41,8,999,490,642,655,2786
22:58:42,8,998,497,643,519,2657
22:58:43,8,998,496,642,613,2749
22:58:44,8,999,493,642,447,2581
22:58:45,8,998,493,641,610,2742
22:58:46,8,999,489,639,479,2606
22:58:47,8,999,491,639,659,2788
22:58:48,8,0,0,0,0,0
22:58:49,8,0,0,0,0,0
22:58:50,8,998,487,637,659,2781
22:58:51,8,999,491,637,625,2752
22:58:52,8,999,478,637,505,2619
22:58:53,8,999,491,637,825,2952
22:58:54,8,1000,501,637,877,3015
22:58:55,8,999,494,638,888,3019
22:58:56,8,999,495,640,949,3083
22:58:57,8,998,487,642,939,3066
22:58:58,8,0,0,0,0,0
22:58:59,8,1001,497,646,987,3131
22:59:00,8,999,493,653,910,3055
22:59:01,8,999,472,664,972,3107
22:59:02,8,998,503,664,893,3058
22:59:03,8,1000,495,668,839,3002
22:59:04,8,996,492,669,850,3007
22:59:05,8,0,0,0,0,0
22:59:06,8,0,0,0,0,0
22:59:07,8,997,498,666,832,2993
22:59:08,8,998,486,666,886,3036
22:59:09,8,998,494,664,926,3082
22:59:10,8,998,494,663,930,3085
22:59:11,8,0,0,0,0,0
22:59:12,8,998,489,661,900,3048
22:59:13,8,998,498,661,961,3118
22:59:14,8,0,0,0,0,0
22:59:15,8,998,489,659,967,3113
22:59:16,8,999,493,658,959,3109
22:59:17,8,998,478,656,877,3009
22:59:18,8,998,491,655,943,3087
22:59:19,8,0,0,0,0,0
22:59:20,8,0,0,0,0,0
22:59:21,8,0,0,0,0,0
22:59:22,8,998,488,652,934,3072
22:59:23,8,998,497,652,950,3097
22:59:24,8,998,486,651,886,3021
22:59:25,8,998,488,650,900,3036
22:59:26,8,998,488,650,853,2989
22:59:27,8,998,498,649,910,3055
22:59:28,8,999,492,650,880,3021
22:59:29,8,999,497,649,922,3067
22:59:30,8,999,487,647,894,3027
22:59:31,8,998,489,646,894,3027
22:59:32,8,998,490,645,879,3012
22:59:33,8,998,490,644,859,2991
22:59:34,8,998,661,644,919,3222
22:59:35,8,998,422,642,884,2946
22:59:36,8,999,459,642,899,2999
22:59:37,8,998,485,642,876,3001
22:59:38,8,998,488,641,919,3046
22:59:39,8,998,493,640,896,3027
22:59:40,8,998,495,640,894,3027
22:59:41,8,999,492,641,947,3079
22:59:42,8,998,495,640,896,3029
22:59:43,8,998,488,640,897,3023
22:59:44,8,998,491,639,910,3038
22:59:45,8,998,487,638,875,2998
22:59:46,8,998,510,637,870,3015
22:59:47,8,998,570,637,892,3097
22:59:48,8,998,529,636,869,3032
22:59:49,8,998,514,636,923,3071
22:59:50,8,998,481,636,886,3001
22:59:51,8,999,502,636,875,3012
22:59:52,8,998,565,635,884,3082
22:59:53,8,998,484,635,895,3012
22:59:54,8,998,478,634,853,2963
22:59:55,8,999,489,633,885,3006
22:59:56,8,998,488,633,878,2997
22:59:57,8,998,491,634,915,3038
22:59:58,8,998,489,634,943,3064
22:59:59,8,999,491,633,893,3016
23:00:00,8,998,493,633,933,3057
23:00:01,8,998,488,632,870,2988
23:00:02,8,999,498,632,952,3081
23:00:03,8,998,490,632,856,2976
23:00:04,8,998,491,632,906,3027
23:00:05,8,998,493,632,911,3034
23:00:06,8,999,488,631,811,2929
23:00:07,8,999,491,631,968,3089
23:00:08,8,999,492,631,856,2978
23:00:09,8,0,0,0,0,0
23:00:10,8,998,492,630,941,3061
23:00:11,8,998,489,630,900,3017
23:00:12,8,998,485,629,914,3026
23:00:13,8,998,500,629,924,3051
23:00:14,8,999,490,630,885,3004
23:00:15,8,998,488,630,903,3019
23:00:16,8,998,488,630,899,3015
23:00:17,8,998,487,630,905,3020
23:00:18,8,998,492,630,929,3049
23:00:19,8,998,491,630,893,3012
23:00:20,8,998,499,630,877,3004
23:00:21,8,998,487,630,821,2936
23:00:22,8,999,492,629,933,3053
23:00:23,8,999,487,629,920,3035
23:00:24,8,998,493,628,936,3055
23:00:25,8,999,491,629,914,3033
23:00:26,8,998,481,627,900,3006
23:00:27,8,998,490,627,919,3034
23:00:28,8,998,488,628,901,3015
23:00:29,8,999,492,628,925,3044
23:00:30,8,998,497,628,913,3036
23:00:31,8,0,0,0,0,0
23:00:32,8,0,0,0,0,0
23:00:33,8,998,486,627,911,3022
23:00:34,8,998,499,627,901,3025
23:00:35,8,998,488,627,881,2994
23:00:36,8,998,489,626,919,3032
23:00:37,8,998,494,626,985,3103
23:00:38,8,998,488,625,924,3035
23:00:39,8,998,492,625,933,3048
23:00:40,8,998,492,624,976,3090
23:00:41,8,999,487,624,949,3059
23:00:42,8,999,490,623,912,3024
23:00:43,8,999,482,622,970,3073
23:00:44,8,998,490,622,931,3041
23:00:45,8,998,486,622,949,3055
23:00:46,8,999,490,621,982,3092
23:00:47,8,999,491,621,920,3031
23:00:48,8,999,488,621,958,3066
23:00:49,8,998,486,621,936,3041
23:00:50,8,999,489,620,973,3081
23:00:51,8,998,490,619,941,3048
23:00:52,8,998,488,619,940,3045
23:00:53,8,998,489,619,949,3055
23:00:54,8,998,484,619,953,3054
23:00:55,8,998,483,619,925,3025
23:00:56,8,999,494,619,922,3034
23:00:57,8,0,0,0,0,0
23:00:58,8,0,0,0,0,0
23:00:59,8,999,490,617,115,2221
23:01:00,8,998,480,617,204,2299
23:01:01,8,0,0,0,0,0
23:01:02,8,999,452,617,186,2254
23:01:03,8,998,469,617,141,2225
23:01:04,8,997,484,617,117,2215
23:01:05,8,998,488,616,107,2209
23:01:06,8,998,484,615,177,2274
23:01:07,8,998,482,614,92,2186
23:01:08,8,998,488,613,11,2110
23:01:09,8,998,483,612,83,2176
23:01:10,8,999,490,612,141,2242
23:01:11,8,998,484,611,141,2234
23:01:12,8,999,493,610,108,2210
23:01:13,8,998,484,609,117,2208
23:01:14,8,999,488,608,190,2285
23:01:15,8,999,493,608,119,2219
23:01:16,8,999,491,608,110,2208
23:01:17,8,999,490,607,124,2220
23:01:18,8,999,489,608,116,2212
23:01:19,8,999,492,607,3,2101
23:01:20,8,999,477,607,0,2083
23:01:21,8,999,490,607,2,2098
23:01:22,8,999,495,606,5,2105
23:01:23,8,999,487,605,2,2093
23:01:24,8,999,492,605,2,2098
23:01:25,8,999,494,605,4,2102
23:01:26,8,999,486,605,2,2092
23:01:27,8,999,490,604,3,2096
23:01:28,8,1000,492,604,3,2099
23:01:29,8,999,499,604,0,2102
23:01:30,8,1000,465,605,3,2073
23:01:31,8,999,488,602,2,2091
23:01:32,8,999,491,601,1,2092
23:01:33,8,999,486,599,3,2087
23:01:34,8,0,0,0,0,0
23:01:35,8,999,498,596,2,2095
23:01:36,8,1000,480,595,3,2078
23:01:37,8,1000,494,594,3,2091
23:01:38,8,1000,486,593,2,2081
23:01:39,8,1000,487,592,2,2081
23:01:40,8,1000,493,591,1,2085
23:01:41,8,1000,475,591,4,2070
23:01:42,8,1000,485,589,2,2076
23:01:43,8,1000,497,589,1,2087
23:01:44,8,1000,492,587,3,2082
23:01:45,8,0,0,0,0,0
23:01:46,8,1000,497,586,1,2084
23:01:47,8,1000,486,585,2,2073
23:01:48,8,0,0,0,0,0
23:01:49,8,1000,494,583,1,2078
23:01:50,8,1000,480,583,2,2065
23:01:51,8,1000,491,582,4,2077
23:01:52,8,1000,489,581,3,2073
23:01:53,8,1000,496,581,0,2077
23:01:54,8,1000,490,580,1,2071
23:01:55,8,0,0,0,0,0
23:01:56,8,1000,502,579,1,2082
23:01:57,8,1000,501,579,0,2080
23:01:58,8,1001,483,579,1,2064
23:01:59,8,1001,501,578,0,2080
23:02:00,8,1000,485,577,0,2062
23:02:01,8,1000,488,576,1,2065
23:02:02,8,1001,480,576,1,2058
23:02:03,8,1001,491,576,1,2069
23:02:04,8,1001,492,575,2,2070
23:02:05,8,1001,496,574,1,2072
23:02:06,8,1001,493,573,0,2067
23:02:07,8,1001,503,573,1,2078
23:02:08,8,0,0,0,0,0
23:02:09,8,1001,492,572,2,2067
23:02:10,8,1000,487,571,0,2058
23:02:11,8,1001,494,571,0,2066
23:02:12,8,1001,481,570,1,2053
23:02:13,8,0,0,0,0,0
23:02:14,8,1001,476,569,1,2047
23:02:15,8,1001,486,566,1,2054
23:02:16,8,1001,490,565,1,2057
23:02:17,8,1001,489,563,1,2054
23:02:18,8,0,0,0,0,0
23:02:19,8,1001,490,562,1,2054
23:02:20,8,1001,478,561,1,2041
23:02:21,8,1001,484,560,1,2046
23:02:22,8,1001,488,559,0,2048
23:02:23,8,1001,487,559,1,2048
23:02:24,8,1001,482,558,1,2042
23:02:25,8,1002,490,558,1,2051
23:02:26,8,1002,490,558,0,2050
23:02:27,8,1001,488,557,0,2046
23:02:28,8,1001,484,556,1,2042
23:02:29,8,1002,492,557,0,2051
23:02:30,8,1001,493,557,1,2052
23:02:31,8,1001,489,557,0,2047
23:02:32,8,1001,493,557,0,2051
23:02:33,8,1002,486,556,2,2046
23:02:34,8,0,0,0,0,0
23:02:35,8,1002,488,556,1,2047
23:02:36,8,1001,487,556,1,2045
23:02:37,8,1001,485,557,0,2043
23:02:38,8,1001,489,556,2,2048
23:02:39,8,1001,492,556,0,2049
23:02:40,8,1001,489,556,0,2046
23:02:41,8,1001,484,556,2,2043
23:02:42,8,1001,486,555,2,2044
23:02:43,8,1001,493,554,1,2049
23:02:44,8,1002,476,554,2,2034
23:02:45,8,1001,488,554,1,2044
23:02:46,8,1002,490,554,1,2047
23:02:47,8,1001,491,554,1,2047
23:02:48,8,1001,492,554,0,2047
23:02:49,8,1001,490,554,0,2045
23:02:50,8,1001,488,554,0,2043
23:02:51,8,1001,488,554,1,2044
23:02:52,8,1002,493,554,0,2049
23:02:53,8,1001,493,554,0,2048
23:02:54,8,1001,486,554,2,2043
23:02:55,8,1000,489,554,0,2043
23:02:56,8,1000,491,554,0,2045
23:02:57,8,1001,488,554,1,2044
23:02:58,8,1001,486,555,0,2042
23:02:59,8,1001,490,554,1,2046
23:03:00,8,1000,486,554,1,2041
23:03:01,8,1001,492,554,1,2048
23:03:02,8,1001,491,554,0,2046
23:03:03,8,1000,483,554,1,2038
23:03:04,8,1000,495,555,0,2050
23:03:05,8,1000,490,555,0,2045
23:03:06,8,1000,491,556,1,2048
23:03:07,8,1001,493,556,0,2050
23:03:08,8,1000,494,556,0,2050
23:03:09,8,1000,496,555,2,2053
23:03:10,8,1001,484,555,0,2040
23:03:11,8,1001,493,555,1,2050
23:03:12,8,1001,487,556,0,2044
23:03:13,8,1000,488,556,0,2044
23:03:14,8,1001,484,557,1,2043
23:03:15,8,0,0,0,0,0
23:03:16,8,1001,491,557,1,2050
23:03:17,8,1001,487,557,0,2045
23:03:18,8,1000,487,557,0,2044
23:03:19,8,1000,457,557,0,2014
23:03:20,8,1000,485,558,1,2044
23:03:21,8,1000,486,558,1,2045
23:03:22,8,1000,467,557,0,2024
23:03:23,8,1000,491,557,1,2049
23:03:24,8,1000,490,558,0,2048
23:03:25,8,1000,479,558,2,2039
23:03:26,8,1000,488,558,1,2047
23:03:27,8,1000,493,558,0,2051
23:03:28,8,1000,483,559,1,2043
23:03:29,8,1000,489,559,1,2049
23:03:30,8,1000,490,559,1,2050
23:03:31,8,999,493,559,0,2051
23:03:32,8,1000,482,559,1,2042
23:03:33,8,1000,483,559,0,2042
23:03:34,8,1000,486,559,1,2046
23:03:35,8,1000,483,559,2,2044
23:03:36,8,1000,496,559,0,2055
23:03:37,8,1000,488,560,1,2049
23:03:38,8,1000,490,560,1,2051
23:03:39,8,1000,485,560,1,2046
23:03:40,8,1000,490,560,0,2050
23:03:41,8,1000,488,560,0,2048
23:03:42,8,1000,487,560,0,2047
23:03:43,8,1000,482,560,0,2042
23:03:44,8,1000,485,560,1,2046
23:03:45,8,1000,493,560,1,2054
23:03:46,8,999,484,560,0,2043
23:03:47,8,999,498,560,1,2058
23:03:48,8,1000,489,560,0,2049
23:03:49,8,1000,492,561,1,2054
23:03:50,8,1000,486,561,1,2048
23:03:51,8,1000,485,561,1,2047
23:03:52,8,1000,492,561,0,2053
23:03:53,8,1000,489,561,1,2051
23:03:54,8,1000,489,561,0,2050
23:03:55,8,1000,490,561,0,2051
23:03:56,8,0,0,0,0,0
23:03:57,8,999,486,562,2,2049
23:03:58,8,1000,488,562,0,2050
23:03:59,8,1000,487,562,1,2050
23:04:00,8,0,0,0,0,0
23:04:01,8,1000,492,562,1,2055
23:04:02,8,1000,489,562,0,2051
23:04:03,8,1000,491,561,0,2052
23:04:04,8,1000,490,561,1,2052
23:04:05,8,1000,484,562,1,2047
23:04:06,8,1000,486,561,1,2048
23:04:07,8,1000,489,562,1,2052
23:04:08,8,1000,487,561,1,2049
23:04:09,8,0,0,0,0,0
23:04:10,8,1001,486,562,0,2049
23:04:11,8,1000,481,562,1,2044
23:04:12,8,1001,487,562,0,2050
23:04:13,8,1001,483,562,0,2046
23:04:14,8,1000,487,562,2,2051
23:04:15,8,1000,488,562,0,2050
23:04:16,8,1000,483,562,1,2046
23:04:17,8,1000,489,561,1,2051
23:04:18,8,1000,485,561,0,2046
23:04:19,8,1000,492,561,0,2053
23:04:20,8,1000,494,562,0,2056
23:04:21,8,1000,490,562,0,2052
23:04:22,8,1000,491,562,0,2053
23:04:23,8,1000,485,562,1,2048
23:04:24,8,1000,485,562,2,2049
23:04:25,8,1000,487,562,1,2050
23:04:26,8,999,490,561,1,2051
23:04:27,8,999,494,561,0,2054
23:04:28,8,1000,491,562,0,2053
23:04:29,8,999,490,561,1,2051
23:04:30,8,999,489,562,1,2051
23:04:31,8,999,480,561,0,2040
23:04:32,8,999,488,562,1,2050
23:04:33,8,1000,490,562,1,2053
23:04:34,8,999,487,562,0,2048
23:04:35,8,999,487,561,0,2047
23:04:36,8,999,489,562,0,2050
23:04:37,8,999,493,562,1,2055
23:04:38,8,999,490,562,1,2052
23:04:39,8,999,491,562,1,2053
23:04:40,8,999,488,562,1,2050
23:04:41,8,999,486,562,0,2047
23:04:42,8,999,490,562,0,2051
23:04:43,8,999,493,562,1,2055
23:04:44,8,999,485,562,0,2046
23:04:45,8,999,487,562,0,2048
23:04:46,8,998,479,562,2,2041
23:04:47,8,999,484,562,1,2046
23:04:48,8,999,491,562,1,2053
23:04:49,8,999,482,562,1,2044
23:04:50,8,998,489,562,0,2049
23:04:51,8,999,498,562,0,2059
23:04:52,8,999,490,562,0,2051
23:04:53,8,999,482,562,1,2044
23:04:54,8,999,487,562,1,2049
23:04:55,8,999,480,562,0,2041
23:04:56,8,999,490,562,0,2051
23:04:57,8,998,486,562,0,2046
23:04:58,8,998,489,562,1,2050
23:04:59,8,0,0,0,0,0
23:05:00,8,999,495,562,1,2057
23:05:01,8,998,487,562,0,2047
23:05:02,8,999,490,562,1,2052
23:05:03,8,999,482,561,0,2042
23:05:04,8,999,479,562,0,2040
23:05:05,8,999,488,562,2,2051
23:05:06,8,999,485,562,1,2047
23:05:07,8,1000,483,562,0,2045
23:05:08,8,999,485,562,2,2048
23:05:09,8,999,490,562,1,2052
23:05:10,8,999,490,562,1,2052
23:05:11,8,999,489,562,1,2051
23:05:12,8,999,491,562,1,2053
23:05:13,8,999,493,562,1,2055
23:05:14,8,999,490,562,1,2052
23:05:15,8,998,486,562,1,2047
23:05:16,8,999,490,562,0,2051
23:05:17,8,999,492,562,1,2054
23:05:18,8,999,487,562,1,2049
23:05:19,8,998,490,562,0,2050
23:05:20,8,998,491,562,1,2052
23:05:21,8,999,488,562,1,2050
23:05:22,8,999,487,562,1,2049
23:05:23,8,999,489,561,0,2049
23:05:24,8,999,489,561,0,2049
23:05:25,8,999,490,561,1,2051
23:05:26,8,999,484,562,1,2046
23:05:27,8,999,494,562,1,2056
23:05:28,8,999,489,562,0,2050
23:05:29,8,999,490,562,0,2051
23:05:30,8,999,492,562,1,2054
23:05:31,8,999,489,562,0,2050
23:05:32,8,999,493,562,1,2055
23:05:33,8,999,485,562,0,2046
23:05:34,8,999,491,562,0,2052
23:05:35,8,1000,494,562,1,2057
23:05:36,8,999,484,561,1,2045
23:05:37,8,999,486,561,1,2047
23:05:38,8,999,488,561,1,2049
23:05:39,8,999,489,561,0,2049
23:05:40,8,1000,482,561,1,2044
23:05:41,8,1000,490,561,1,2052
23:05:42,8,999,487,561,1,2048
23:05:43,8,1000,494,561,0,2055
23:05:44,8,1000,487,560,0,2047
23:05:45,8,1000,486,561,0,2047
23:05:46,8,1000,491,560,1,2052
23:05:47,8,999,487,560,0,2046
23:05:48,8,1000,482,561,0,2043
23:05:49,8,1000,499,560,0,2059
23:05:50,8,1000,487,560,0,2047
23:05:51,8,1000,488,560,2,2050
23:05:52,8,1000,493,561,0,2054
23:05:53,8,1000,493,560,0,2053
23:05:54,8,0,0,0,0,0
23:05:55,8,1000,493,561,2,2056
23:05:56,8,999,486,560,1,2046
23:05:57,8,999,495,561,1,2056
23:05:58,8,999,483,561,1,2044
23:05:59,8,999,489,560,1,2049
23:06:00,8,999,487,560,1,2047
23:06:01,8,999,490,560,1,2050
23:06:02,8,999,490,561,0,2050
23:06:03,8,999,488,560,0,2047
23:06:04,8,1000,489,560,0,2049
23:06:05,8,999,492,560,1,2052
23:06:06,8,998,492,561,0,2051
23:06:07,8,999,491,561,0,2051
23:06:08,8,999,483,561,1,2044
23:06:09,8,999,496,561,0,2056
23:06:10,8,999,492,561,1,2053
23:06:11,8,998,486,561,1,2046
23:06:12,8,999,490,561,0,2050
23:06:13,8,999,492,561,2,2054
23:06:14,8,998,494,561,1,2054
23:06:15,8,998,495,561,0,2054
23:06:16,8,998,486,561,0,2045
23:06:17,8,998,491,561,0,2050
23:06:18,8,998,490,561,0,2049
23:06:19,8,995,490,561,1,2047
23:06:20,8,996,486,561,1,2044
23:06:21,8,0,0,0,0,0
23:06:22,8,995,496,561,1,2053
23:06:23,8,0,0,0,0,0
23:06:24,8,996,491,561,1,2049
23:06:25,8,996,489,561,1,2047
23:06:26,8,997,491,561,0,2049
23:06:27,8,997,493,561,1,2052
23:06:28,8,997,484,561,2,2044
23:06:29,8,997,493,561,0,2051
23:06:30,8,0,0,0,0,0
23:06:31,8,997,484,561,0,2042
23:06:32,8,997,478,561,0,2036
23:06:33,8,997,490,561,0,2048
23:06:34,8,997,496,561,2,2056
23:06:35,8,997,485,560,2,2044
23:06:36,8,997,491,560,0,2048
23:06:37,8,0,0,0,0,0
23:06:38,8,997,478,560,0,2035
23:06:39,8,997,485,559,2,2043
23:06:40,8,996,489,559,0,2044
23:06:41,8,997,494,559,2,2052
23:06:42,8,997,480,559,0,2036
23:06:43,8,997,487,559,1,2044
23:06:44,8,997,491,559,1,2048
23:06:45,8,0,0,0,0,0
23:06:46,8,997,490,559,1,2047
23:06:47,8,0,0,0,0,0
23:06:48,8,0,0,0,0,0
23:06:49,8,997,486,559,0,2042
23:06:50,8,997,479,559,0,2035
23:06:51,8,997,483,559,1,2040
23:06:52,8,997,484,559,1,2041
23:06:53,8,997,492,559,0,2048
23:06:54,8,0,0,0,0,0
23:06:55,8,997,480,559,0,2036
23:06:56,8,997,477,559,2,2035
23:06:57,8,996,484,559,0,2039
23:06:58,8,997,486,559,0,2042
23:06:59,8,996,503,559,1,2059
23:07:00,8,996,487,559,1,2043
23:07:01,8,996,494,558,0,2048
23:07:02,8,996,490,558,0,2044
23:07:03,8,996,490,559,0,2045
23:07:04,8,995,491,558,0,2044
23:07:05,8,996,492,559,0,2047
22:50:41,9,0,0,0,0,0
22:50:42,9,0,0,0,0,0
22:50:43,9,0,0,0,0,0
22:50:44,9,0,0,0,0,0
22:50:45,9,1000,476,536,0,2012
22:50:46,9,0,0,0,0,0
22:50:47,9,1000,494,536,0,2030
22:50:48,9,0,0,0,0,0
22:50:49,9,1001,489,536,0,2026
22:50:50,9,1000,497,536,0,2033
22:50:51,9,0,0,0,0,0
22:50:52,9,1001,483,536,0,2020
22:50:53,9,0,0,0,0,0
22:50:54,9,0,0,0,0,0
22:50:55,9,1000,489,536,0,2025
22:50:56,9,1000,466,536,0,2002
22:50:57,9,0,0,0,0,0
22:50:58,9,1001,492,536,0,2029
22:50:59,9,0,0,0,0,0
22:51:00,9,0,0,0,0,0
22:51:01,9,1001,480,536,0,2017
22:51:02,9,1001,478,536,0,2015
22:51:03,9,1001,499,536,0,2036
22:51:04,9,1001,484,536,0,2021
22:51:05,9,1000,494,536,0,2030
22:51:06,9,0,0,0,0,0
22:51:07,9,1000,488,536,0,2024
22:51:08,9,0,0,0,0,0
22:51:09,9,0,0,0,0,0
22:51:10,9,1001,487,535,0,2023
22:51:11,9,1001,489,535,0,2025
22:51:12,9,0,0,0,0,0
22:51:13,9,1000,492,535,0,2027
22:51:14,9,0,0,0,0,0
22:51:15,9,0,0,0,0,0
22:51:16,9,0,0,0,0,0
22:51:17,9,1000,490,536,0,2026
22:51:18,9,0,0,0,0,0
22:51:19,9,1000,483,535,0,2018
22:51:20,9,1000,480,535,0,2015
22:51:21,9,1001,485,535,0,2021
22:51:22,9,1001,483,535,0,2019
22:51:23,9,1001,490,535,0,2026
22:51:24,9,1000,493,535,0,2028
22:51:25,9,1001,475,535,0,2011
22:51:26,9,1000,495,536,0,2031
22:51:27,9,1000,490,535,0,2025
22:51:28,9,1001,494,536,0,2031
22:51:29,9,1000,484,535,0,2019
22:51:30,9,0,0,0,0,0
22:51:31,9,0,0,0,0,0
22:51:32,9,0,0,0,0,0
22:51:33,9,0,0,0,0,0
22:51:34,9,0,0,0,0,0
22:51:35,9,1000,494,535,0,2029
22:51:36,9,0,0,0,0,0
22:51:37,9,1000,494,535,0,2029
22:51:38,9,1001,485,535,64,2085
22:51:39,9,0,0,0,0,0
22:51:40,9,0,0,0,0,0
22:51:41,9,1001,492,535,514,2542
22:51:42,9,1001,492,535,508,2536
22:51:43,9,0,0,0,0,0
22:51:44,9,0,0,0,0,0
22:51:45,9,1000,486,535,597,2618
22:51:46,9,0,0,0,0,0
22:51:47,9,0,0,0,0,0
22:51:48,9,0,0,0,0,0
22:51:49,9,0,0,0,0,0
22:51:50,9,1000,489,535,264,2288
22:51:51,9,1000,488,535,625,2648
22:51:52,9,1000,492,535,576,2603
22:51:53,9,0,0,0,0,0
22:51:54,9,0,0,0,0,0
22:51:55,9,0,0,0,0,0
22:51:56,9,0,0,0,0,0
22:51:57,9,0,0,0,0,0
22:51:58,9,1001,487,536,501,2525
22:51:59,9,0,0,0,0,0
22:52:00,9,0,0,0,0,0
22:52:01,9,0,0,0,0,0
22:52:02,9,0,0,0,0,0
22:52:03,9,1004,495,574,623,2696
22:52:04,9,1003,499,576,544,2622
22:52:05,9,1001,519,575,510,2605
22:52:06,9,1001,497,574,501,2573
22:52:07,9,1001,475,575,499,2550
22:52:08,9,1002,482,580,459,2523
22:52:09,9,1004,476,586,422,2488
22:52:10,9,1005,472,600,471,2548
22:52:11,9,1005,469,613,511,2598
22:52:12,9,1003,506,616,468,2593
22:52:13,9,1003,490,617,588,2698
22:52:14,9,0,0,0,0,0
22:52:15,9,1005,492,621,602,2720
22:52:16,9,1008,499,659,543,2709
22:52:17,9,1004,516,690,561,2771
22:52:18,9,999,590,688,507,2784
22:52:19,9,992,470,678,535,2675
22:52:20,9,994,494,672,469,2629
22:52:21,9,985,516,675,502,2678
22:52:22,9,980,474,676,447,2577
22:52:23,9,987,497,683,518,2685
22:52:24,9,986,495,691,438,2610
22:52:25,9,987,473,691,351,2502
22:52:26,9,0,0,0,0,0
22:52:27,9,984,470,695,640,2789
22:52:28,9,974,507,700,602,2783
22:52:29,9,975,489,702,519,2685
22:52:30,9,964,489,701,509,2663
22:52:31,9,961,500,700,482,2643
22:52:32,9,958,485,699,507,2649
22:52:33,9,966,509,698,867,3040
22:52:34,9,967,490,698,878,3033
22:52:35,9,966,489,698,882,3035
22:52:36,9,971,483,697,867,3018
22:52:37,9,970,487,698,882,3037
22:52:38,9,966,482,700,864,3012
22:52:39,9,969,486,701,870,3026
22:52:40,9,971,496,702,845,3014
22:52:41,9,973,497,701,927,3098
22:52:42,9,975,491,701,846,3013
22:52:43,9,971,462,701,868,3002
22:52:44,9,966,475,701,906,3048
22:52:45,9,960,485,700,889,3034
22:52:46,9,962,493,699,858,3012
22:52:47,9,962,492,698,867,3019
22:52:48,9,959,496,698,884,3037
22:52:49,9,958,478,699,970,3105
22:52:50,9,0,0,0,0,0
22:52:51,9,0,0,0,0,0
22:52:52,9,0,0,0,0,0
22:52:53,9,960,491,698,832,2981
22:52:54,9,0,0,0,0,0
22:52:55,9,0,0,0,0,0
22:52:56,9,959,500,696,830,2985
22:52:57,9,967,509,694,789,2959
22:52:58,9,963,491,693,802,2949
22:52:59,9,961,496,693,974,3124
22:53:00,9,961,504,692,920,3077
22:53:01,9,962,504,695,883,3044
22:53:02,9,0,0,0,0,0
22:53:03,9,0,0,0,0,0
22:53:04,9,957,491,695,844,2987
22:53:05,9,0,0,0,0,0
22:53:06,9,956,507,696,823,2982
22:53:07,9,956,505,694,847,3002
22:53:08,9,0,0,0,0,0
22:53:09,9,0,0,0,0,0
22:53:10,9,0,0,0,0,0
22:53:11,9,967,512,692,816,2987
22:53:12,9,977,481,692,894,3044
22:53:13,9,961,478,692,878,3009
22:53:14,9,970,488,692,894,3044
22:53:15,9,966,488,692,865,3011
22:53:16,9,966,490,692,906,3054
22:53:17,9,963,486,692,879,3020
22:53:18,9,958,485,691,865,2999
22:53:19,9,958,486,690,872,3006
22:53:20,9,958,487,688,862,2995
22:53:21,9,960,485,687,873,3005
22:53:22,9,963,488,687,845,2983
22:53:23,9,961,485,686,881,3013
22:53:24,9,960,484,685,887,3016
22:53:25,9,960,482,685,861,2988
22:53:26,9,960,483,684,863,2990
22:53:27,9,960,490,684,871,3005
22:53:28,9,961,489,684,895,3029
22:53:29,9,964,479,684,871,2998
22:53:30,9,963,477,683,862,2985
22:53:31,9,961,484,683,877,3005
22:53:32,9,960,486,682,891,3019
22:53:33,9,959,486,680,866,2991
22:53:34,9,959,485,680,850,2974
22:53:35,9,0,0,0,0,0
22:53:36,9,964,485,680,951,3080
22:53:37,9,0,0,0,0,0
22:53:38,9,966,458,680,803,2907
22:53:39,9,960,488,680,953,3081
22:53:40,9,959,483,680,874,2996
22:53:41,9,0,0,0,0,0
22:53:42,9,961,491,679,935,3066
22:53:43,9,0,0,0,0,0
22:53:44,9,958,485,679,914,3036
22:53:45,9,958,486,678,961,3083
22:53:46,9,0,0,0,0,0
22:53:47,9,959,490,676,927,3052
22:53:48,9,960,490,675,781,2906
22:53:49,9,960,484,675,888,3007
22:53:50,9,961,492,674,779,2906
22:53:51,9,0,0,0,0,0
22:53:52,9,0,0,0,0,0
22:53:53,9,0,0,0,0,0
22:53:54,9,0,0,0,0,0
22:53:55,9,961,489,673,917,3040
22:53:56,9,965,488,672,797,2922
22:53:57,9,960,474,672,911,3017
22:53:58,9,963,487,671,914,3035
22:53:59,9,961,473,671,963,3068
22:54:00,9,965,493,671,773,2902
22:54:01,9,0,0,0,0,0
22:54:02,9,960,479,669,854,2962
22:54:03,9,960,493,669,889,3011
22:54:04,9,960,483,669,838,2950
22:54:05,9,960,471,668,920,3019
22:54:06,9,960,487,668,870,2985
22:54:07,9,960,488,667,884,2999
22:54:08,9,961,497,667,964,3089
22:54:09,9,0,0,0,0,0
22:54:10,9,0,0,0,0,0
22:54:11,9,961,483,667,922,3033
22:54:12,9,0,0,0,0,0
22:54:13,9,965,478,665,977,3085
22:54:14,9,0,0,0,0,0
22:54:15,9,980,456,666,988,3090
22:54:16,9,978,508,668,867,3021
22:54:17,9,979,492,669,875,3015
22:54:18,9,968,484,670,876,2998
22:54:19,9,969,497,670,874,3010
22:54:20,9,970,486,671,888,3015
22:54:21,9,968,492,671,874,3005
22:54:22,9,962,488,670,886,3006
22:54:23,9,969,485,669,872,2995
22:54:24,9,969,481,670,873,2993
22:54:25,9,962,480,670,864,2976
22:54:26,9,963,492,670,855,2980
22:54:27,9,960,493,670,892,3015
22:54:28,9,960,491,670,879,3000
22:54:29,9,959,483,670,886,2998
22:54:30,9,993,453,671,876,2993
22:54:31,9,997,496,675,878,3046
22:54:32,9,998,489,674,892,3053
22:54:33,9,998,485,675,891,3049
22:54:34,9,998,489,676,854,3017
22:54:35,9,997,486,676,869,3028
22:54:36,9,997,489,677,851,3014
22:54:37,9,997,486,678,878,3039
22:54:38,9,997,494,679,872,3042
22:54:39,9,997,487,683,883,3050
22:54:40,9,998,490,690,885,3063
22:54:41,9,998,484,694,851,3027
22:54:42,9,998,488,690,869,3045
22:54:43,9,997,485,689,886,3057
22:54:44,9,997,487,689,893,3066
22:54:45,9,997,484,689,880,3050
22:54:46,9,997,485,690,869,3041
22:54:47,9,997,483,690,867,3037
22:54:48,9,997,483,689,883,3052
22:54:49,9,997,489,690,868,3044
22:54:50,9,998,488,690,870,3046
22:54:51,9,998,489,690,890,3067
22:54:52,9,998,481,692,880,3051
22:54:53,9,998,486,696,900,3080
22:54:54,9,998,482,695,856,3031
22:54:55,9,998,495,694,875,3062
22:54:56,9,998,484,694,890,3066
22:54:57,9,998,495,693,862,3048
22:54:58,9,998,484,693,861,3036
22:54:59,9,999,479,694,833,3005
22:55:00,9,999,488,694,894,3075
22:55:01,9,999,489,694,869,3051
22:55:02,9,999,500,695,926,3120
22:55:03,9,999,499,695,934,3127
22:55:04,9,1000,467,695,910,3072
22:55:05,9,999,492,695,866,3052
22:55:06,9,998,492,695,901,3086
22:55:07,9,999,482,694,864,3039
22:55:08,9,999,489,694,880,3062
22:55:09,9,999,490,693,876,3058
22:55:10,9,999,489,693,812,2993
22:55:11,9,998,479,692,914,3083
22:55:12,9,998,493,692,880,3063
22:55:13,9,999,490,693,898,3080
22:55:14,9,999,489,697,854,3039
22:55:15,9,1000,485,706,906,3097
22:55:16,9,1001,491,715,899,3106
22:55:17,9,1001,511,728,880,3120
22:55:18,9,1000,485,732,904,3121
22:55:19,9,999,479,733,870,3081
22:55:20,9,1002,496,741,865,3104
22:55:21,9,1000,489,754,856,3099
22:55:22,9,1000,472,760,832,3064
22:55:23,9,998,479,757,885,3119
22:55:24,9,998,627,758,873,3256
22:55:25,9,997,549,763,876,3185
22:55:26,9,997,485,765,913,3160
22:55:27,9,998,485,763,887,3133
22:55:28,9,998,487,764,851,3100
22:55:29,9,998,487,763,853,3101
22:55:30,9,998,499,762,879,3138
22:55:31,9,998,488,763,871,3120
22:55:32,9,997,486,763,869,3115
22:55:33,9,997,499,763,878,3137
22:55:34,9,996,490,762,897,3145
22:55:35,9,995,474,757,893,3119
22:55:36,9,996,488,757,851,3092
22:55:37,9,996,491,754,890,3131
22:55:38,9,996,487,753,857,3093
22:55:39,9,997,488,751,852,3088
22:55:40,9,997,484,749,860,3090
22:55:41,9,997,491,747,890,3125
22:55:42,9,997,490,745,871,3103
22:55:43,9,997,488,743,842,3070
22:55:44,9,997,491,741,847,3076
22:55:45,9,997,486,740,867,3090
22:55:46,9,997,488,738,871,3094
22:55:47,9,997,484,736,898,3115
22:55:48,9,997,493,734,896,3120
22:55:49,9,998,489,733,894,3114
22:55:50,9,998,495,732,883,3108
22:55:51,9,998,488,730,856,3072
22:55:52,9,998,492,728,881,3099
22:55:53,9,998,484,726,899,3107
22:55:54,9,998,486,724,876,3084
22:55:55,9,998,490,723,883,3094
22:55:56,9,998,489,723,895,3105
22:55:57,9,998,492,724,860,3074
22:55:58,9,998,489,722,890,3099
22:55:59,9,998,492,721,886,3097
22:56:00,9,998,490,720,889,3097
22:56:01,9,998,487,717,879,3081
22:56:02,9,998,488,715,862,3063
22:56:03,9,998,489,713,892,3092
22:56:04,9,998,488,712,870,3068
22:56:05,9,998,487,710,894,3089
22:56:06,9,998,489,709,885,3081
22:56:07,9,998,488,707,865,3058
22:56:08,9,998,488,706,892,3084
22:56:09,9,998,489,705,878,3070
22:56:10,9,998,487,704,881,3070
22:56:11,9,998,489,702,850,3039
22:56:12,9,998,489,701,887,3075
22:56:13,9,998,487,700,896,3081
22:56:14,9,998,486,698,869,3051
22:56:15,9,998,488,696,861,3043
22:56:16,9,998,486,695,854,3033
22:56:17,9,998,487,693,888,3066
22:56:18,9,998,488,692,513,2691
22:56:19,9,998,488,692,475,2653
22:56:20,9,998,490,691,499,2678
22:56:21,9,998,488,690,490,2666
22:56:22,9,998,487,689,535,2709
22:56:23,9,998,489,688,547,2722
22:56:24,9,998,488,687,524,2697
22:56:25,9,998,490,687,519,2694
22:56:26,9,998,490,687,547,2722
22:56:27,9,998,488,687,536,2709
22:56:28,9,998,480,686,565,2729
22:56:29,9,999,492,686,505,2682
22:56:30,9,998,490,686,540,2714
22:56:31,9,998,488,685,480,2651
22:56:32,9,998,489,684,518,2689
22:56:33,9,998,486,683,468,2635
22:56:34,9,998,487,682,555,2722
22:56:35,9,998,489,681,495,2663
22:56:36,9,998,489,681,534,2702
22:56:37,9,998,486,683,505,2672
22:56:38,9,999,490,691,568,2748
22:56:39,9,999,490,692,530,2711
22:56:40,9,999,484,692,514,2689
22:56:41,9,999,490,692,519,2700
22:56:42,9,999,488,693,547,2727
22:56:43,9,998,489,692,516,2695
22:56:44,9,999,489,691,511,2690
22:56:45,9,998,488,691,477,2654
22:56:46,9,998,487,692,561,2738
22:56:47,9,999,511,692,477,2679
22:56:48,9,998,490,693,497,2678
22:56:49,9,998,488,693,551,2730
22:56:50,9,998,491,692,481,2662
22:56:51,9,998,486,692,560,2736
22:56:52,9,998,487,691,426,2602
22:56:53,9,998,490,690,585,2763
22:56:54,9,998,494,690,534,2716
22:56:55,9,998,490,689,517,2694
22:56:56,9,998,497,689,526,2710
22:56:57,9,998,485,689,481,2653
22:56:58,9,998,493,689,471,2651
22:56:59,9,998,487,688,892,3065
22:57:00,9,998,488,687,898,3071
22:57:01,9,998,491,687,892,3068
22:57:02,9,998,487,688,883,3056
22:57:03,9,998,492,691,894,3075
22:57:04,9,998,489,690,896,3073
22:57:05,9,998,486,687,895,3066
22:57:06,9,998,486,686,900,3070
22:57:07,9,998,486,685,900,3069
22:57:08,9,997,488,685,916,3086
22:57:09,9,996,486,684,903,3069
22:57:10,9,991,488,683,879,3041
22:57:11,9,992,592,682,873,3139
22:57:12,9,997,485,681,910,3073
22:57:13,9,997,488,680,886,3051
22:57:14,9,997,485,680,909,3071
22:57:15,9,997,480,681,891,3049
22:57:16,9,997,489,682,905,3073
22:57:17,9,997,491,682,879,3049
22:57:18,9,998,492,685,886,3061
22:57:19,9,997,478,690,891,3056
22:57:20,9,997,485,688,447,2617
22:57:21,9,997,491,686,522,2696
22:57:22,9,998,487,684,476,2645
22:57:23,9,998,484,683,555,2720
22:57:24,9,998,489,683,558,2728
22:57:25,9,998,486,682,577,2743
22:57:26,9,998,491,682,466,2637
22:57:27,9,998,490,682,456,2626
22:57:28,9,998,492,685,448,2623
22:57:29,9,998,492,688,491,2669
22:57:30,9,998,489,688,502,2677
22:57:31,9,998,491,689,427,2605
22:57:32,9,998,485,692,455,2630
22:57:33,9,998,493,694,455,2640
22:57:34,9,998,492,696,507,2693
22:57:35,9,998,486,696,485,2665
22:57:36,9,998,486,698,460,2642
22:57:37,9,998,490,704,533,2725
22:57:38,9,998,490,709,464,2661
22:57:39,9,998,487,708,516,2709
22:57:40,9,998,485,709,531,2723
22:57:41,9,998,488,714,499,2699
22:57:42,9,998,484,713,558,2753
22:57:43,9,998,489,710,489,2686
22:57:44,9,998,490,709,441,2638
22:57:45,9,998,485,709,420,2612
22:57:46,9,998,486,709,557,2750
22:57:47,9,998,493,709,495,2695
22:57:48,9,998,486,710,606,2800
22:57:49,9,998,487,712,488,2685
22:57:50,9,998,481,711,481,2671
22:57:51,9,998,490,713,507,2708
22:57:52,9,998,485,714,488,2685
22:57:53,9,997,485,716,478,2676
22:57:54,9,998,492,722,475,2687
22:57:55,9,998,490,723,514,2725
22:57:56,9,998,489,724,551,2762
22:57:57,9,998,494,726,503,2721
22:57:58,9,998,491,727,508,2724
22:57:59,9,998,488,727,471,2684
22:58:00,9,998,487,730,514,2729
22:58:01,9,997,488,732,487,2704
22:58:02,9,997,485,738,913,3133
22:58:03,9,997,488,739,898,3122
22:58:04,9,997,489,740,880,3106
22:58:05,9,998,487,743,904,3132
22:58:06,9,997,491,744,875,3107
22:58:07,9,997,493,746,868,3104
22:58:08,9,998,486,747,872,3103
22:58:09,9,998,500,752,936,3186
22:58:10,9,997,490,753,903,3143
22:58:11,9,997,493,752,880,3122
22:58:12,9,997,481,748,891,3117
22:58:13,9,997,489,748,885,3119
22:58:14,9,998,481,748,899,3126
22:58:15,9,998,487,748,903,3136
22:58:16,9,998,488,748,896,3130
22:58:17,9,998,482,747,915,3142
22:58:18,9,998,488,747,898,3131
22:58:19,9,998,491,746,910,3145
22:58:20,9,998,481,744,900,3123
22:58:21,9,998,490,741,910,3139
22:58:22,9,998,485,738,886,3107
22:58:23,9,998,488,737,901,3124
22:58:24,9,999,489,737,874,3099
22:58:25,9,999,493,736,904,3132
22:58:26,9,999,481,736,905,3121
22:58:27,9,999,489,735,870,3093
22:58:28,9,999,488,735,869,3091
22:58:29,9,999,490,734,891,3114
22:58:30,9,999,491,733,900,3123
22:58:31,9,999,490,732,903,3124
22:58:32,9,999,486,732,889,3106
22:58:33,9,999,495,731,884,3109
22:58:34,9,999,487,731,918,3135
22:58:35,9,999,490,731,483,2703
22:58:36,9,999,495,730,535,2759
22:58:37,9,999,486,729,495,2709
22:58:38,9,999,490,729,586,2804
22:58:39,9,999,488,732,608,2827
22:58:40,9,999,491,735,521,2746
22:58:41,9,999,487,735,520,2741
22:58:42,9,999,492,735,516,2742
22:58:43,9,999,487,734,496,2716
22:58:44,9,1000,486,733,543,2762
22:58:45,9,999,486,736,563,2784
22:58:46,9,999,491,744,595,2829
22:58:47,9,999,492,744,615,2850
22:58:48,9,999,492,743,497,2731
22:58:49,9,999,490,742,568,2799
22:58:50,9,999,490,741,513,2743
22:58:51,9,1000,482,741,488,2711
22:58:52,9,1000,484,741,555,2780
22:58:53,9,1000,484,741,897,3122
22:58:54,9,1000,485,742,893,3120
22:58:55,9,1000,487,742,879,3108
22:58:56,9,1000,487,743,913,3143
22:58:57,9,999,496,742,904,3141
22:58:58,9,1000,490,739,911,3140
22:58:59,9,1000,493,740,916,3149
22:59:00,9,1000,493,743,905,3141
22:59:01,9,999,488,743,903,3133
22:59:02,9,999,488,743,894,3124
22:59:03,9,998,488,743,889,3118
22:59:04,9,998,491,742,901,3132
22:59:05,9,999,496,741,883,3119
22:59:06,9,999,488,742,907,3136
22:59:07,9,999,489,741,869,3098
22:59:08,9,999,487,741,884,3111
22:59:09,9,999,492,740,885,3116
22:59:10,9,999,488,740,923,3150
22:59:11,9,999,491,741,903,3134
22:59:12,9,999,492,741,912,3144
22:59:13,9,1000,491,742,907,3140
22:59:14,9,999,487,742,903,3131
22:59:15,9,1000,490,744,925,3159
22:59:16,9,1000,493,744,872,3109
22:59:17,9,1000,488,745,916,3149
22:59:18,9,1000,489,743,893,3125
22:59:19,9,1000,491,743,894,3128
22:59:20,9,1000,492,744,939,3175
22:59:21,9,1000,486,744,906,3136
22:59:22,9,1000,486,743,930,3159
22:59:23,9,1000,487,741,862,3090
22:59:24,9,1000,491,740,903,3134
22:59:25,9,1000,491,740,890,3121
22:59:26,9,1000,487,739,892,3118
22:59:27,9,1001,492,737,912,3142
22:59:28,9,1001,488,736,890,3115
22:59:29,9,1001,487,735,905,3128
22:59:30,9,1001,489,734,917,3141
22:59:31,9,1001,487,733,869,3090
22:59:32,9,1000,497,732,913,3142
22:59:33,9,1001,490,732,899,3122
22:59:34,9,1000,483,729,908,3120
22:59:35,9,1000,493,728,894,3115
22:59:36,9,1000,491,728,856,3075
22:59:37,9,1000,496,728,914,3138
22:59:38,9,1000,488,728,912,3128
22:59:39,9,1000,487,727,934,3148
22:59:40,9,1000,489,725,917,3131
22:59:41,9,1000,480,724,870,3074
22:59:42,9,1000,486,725,904,3115
22:59:43,9,1000,488,725,887,3100
22:59:44,9,1000,491,724,889,3104
22:59:45,9,1000,492,724,902,3118
22:59:46,9,1001,504,723,887,3115
22:59:47,9,1000,488,723,894,3105
22:59:48,9,1000,473,722,929,3124
22:59:49,9,1000,491,720,908,3119
22:59:50,9,1000,507,719,936,3162
22:59:51,9,1001,487,719,912,3119
22:59:52,9,1001,538,717,922,3178
22:59:53,9,1001,491,717,879,3088
22:59:54,9,1000,499,714,876,3089
22:59:55,9,1000,488,713,904,3105
22:59:56,9,1000,490,712,904,3106
22:59:57,9,1000,490,712,889,3091
22:59:58,9,1001,489,711,904,3105
22:59:59,9,1000,487,709,926,3122
23:00:00,9,1001,483,708,886,3078
23:00:01,9,1000,487,708,937,3132
23:00:02,9,1000,486,707,907,3100
23:00:03,9,1000,491,706,898,3095
23:00:04,9,1000,488,706,847,3041
23:00:05,9,1000,485,705,914,3104
23:00:06,9,1000,487,705,903,3095
23:00:07,9,1000,483,705,917,3105
23:00:08,9,1000,484,704,863,3051
23:00:09,9,1000,490,704,919,3113
23:00:10,9,1000,487,704,894,3085
23:00:11,9,1000,487,704,867,3058
23:00:12,9,1000,484,703,914,3101
23:00:13,9,1000,488,700,894,3082
23:00:14,9,1000,484,699,929,3112
23:00:15,9,1000,489,699,941,3129
23:00:16,9,1000,491,697,909,3097
23:00:17,9,1000,489,696,894,3079
23:00:18,9,1000,490,695,893,3078
23:00:19,9,1000,488,694,870,3052
23:00:20,9,1000,500,694,870,3064
23:00:21,9,999,481,694,912,3086
23:00:22,9,1000,489,699,893,3081
23:00:23,9,999,488,702,900,3089
23:00:24,9,999,487,702,906,3094
23:00:25,9,999,489,700,884,3072
23:00:26,9,999,493,699,901,3092
23:00:27,9,999,482,698,879,3058
23:00:28,9,999,510,696,886,3091
23:00:29,9,999,489,696,905,3089
23:00:30,9,999,497,695,889,3080
23:00:31,9,999,488,694,884,3065
23:00:32,9,999,489,693,882,3063
23:00:33,9,999,490,693,885,3067
23:00:34,9,999,491,692,884,3066
23:00:35,9,999,488,691,899,3077
23:00:36,9,999,489,690,883,3061
23:00:37,9,999,490,690,926,3105
23:00:38,9,999,490,688,891,3068
23:00:39,9,999,486,688,951,3124
23:00:40,9,999,490,686,960,3135
23:00:41,9,1000,486,685,946,3117
23:00:42,9,999,488,685,947,3119
23:00:43,9,999,485,684,968,3136
23:00:44,9,999,488,683,943,3113
23:00:45,9,999,488,683,942,3112
23:00:46,9,999,486,682,966,3133
23:00:47,9,999,487,680,952,3118
23:00:48,9,1000,489,678,931,3098
23:00:49,9,999,489,678,967,3133
23:00:50,9,999,488,678,943,3108
23:00:51,9,999,485,677,950,3111
23:00:52,9,999,489,676,943,3107
23:00:53,9,999,488,675,948,3110
23:00:54,9,999,489,673,944,3105
23:00:55,9,999,488,672,950,3109
23:00:56,9,999,494,671,954,3118
23:00:57,9,999,487,669,951,3106
23:00:58,9,999,491,669,138,2297
23:00:59,9,999,489,668,116,2272
23:01:00,9,999,484,667,117,2267
23:01:01,9,999,488,667,102,2256
23:01:02,9,999,498,666,155,2318
23:01:03,9,999,490,665,157,2311
23:01:04,9,999,484,664,122,2269
23:01:05,9,999,480,663,153,2295
23:01:06,9,999,483,663,126,2271
23:01:07,9,999,484,662,88,2233
23:01:08,9,999,487,661,133,2280
23:01:09,9,999,492,661,128,2280
23:01:10,9,999,504,658,111,2272
23:01:11,9,999,489,658,135,2281
23:01:12,9,998,492,658,136,2284
23:01:13,9,998,492,658,184,2332
23:01:14,9,998,486,657,123,2264
23:01:15,9,999,486,655,154,2294
23:01:16,9,998,496,655,121,2270
23:01:17,9,999,487,653,147,2286
23:01:18,9,999,482,652,115,2248
23:01:19,9,999,487,650,2,2138
23:01:20,9,998,473,648,2,2121
23:01:21,9,999,494,648,1,2142
23:01:22,9,999,492,647,2,2140
23:01:23,9,999,489,646,1,2135
23:01:24,9,998,481,646,2,2127
23:01:25,9,998,483,644,1,2126
23:01:26,9,999,486,643,1,2129
23:01:27,9,998,491,642,3,2134
23:01:28,9,999,480,641,2,2122
23:01:29,9,998,477,640,2,2117
23:01:30,9,998,490,639,2,2129
23:01:31,9,998,447,638,2,2085
23:01:32,9,999,488,637,2,2126
23:01:33,9,999,467,636,2,2104
23:01:34,9,998,476,636,2,2112
23:01:35,9,999,489,635,2,2125
23:01:36,9,998,480,635,3,2116
23:01:37,9,999,489,634,2,2124
23:01:38,9,998,486,632,2,2118
23:01:39,9,998,465,632,2,2097
23:01:40,9,998,497,631,2,2128
23:01:41,9,998,497,631,2,2128
23:01:42,9,998,478,630,1,2107
23:01:43,9,998,489,629,2,2118
23:01:44,9,998,489,629,2,2118
23:01:45,9,998,496,628,2,2124
23:01:46,9,998,484,628,2,2112
23:01:47,9,998,488,627,2,2115
23:01:48,9,998,499,627,2,2126
23:01:49,9,998,500,626,2,2126
23:01:50,9,998,480,625,2,2105
23:01:51,9,999,478,625,2,2104
23:01:52,9,998,492,624,2,2116
23:01:53,9,998,502,624,0,2124
23:01:54,9,998,483,623,1,2105
23:01:55,9,999,480,623,0,2102
23:01:56,9,998,499,622,1,2120
23:01:57,9,998,484,622,0,2104
23:01:58,9,999,490,621,1,2111
23:01:59,9,999,492,621,0,2112
23:02:00,9,998,496,620,1,2115
23:02:01,9,999,484,620,1,2104
23:02:02,9,999,483,619,0,2101
23:02:03,9,998,489,618,0,2105
23:02:04,9,998,487,618,0,2103
23:02:05,9,998,479,617,0,2094
23:02:06,9,999,501,617,1,2118
23:02:07,9,999,486,616,1,2102
23:02:08,9,998,486,615,1,2100
23:02:09,9,999,472,614,0,2085
23:02:10,9,999,495,614,1,2109
23:02:11,9,999,500,613,1,2113
23:02:12,9,999,501,613,1,2114
23:02:13,9,999,498,612,0,2109
23:02:14,9,999,481,612,1,2093
23:02:15,9,999,491,611,0,2101
23:02:16,9,999,498,610,1,2108
23:02:17,9,999,483,609,1,2092
23:02:18,9,999,489,608,1,2097
23:02:19,9,999,487,608,1,2095
23:02:20,9,999,488,607,0,2094
23:02:21,9,999,486,605,0,2090
23:02:22,9,999,486,604,1,2090
23:02:23,9,999,487,603,0,2089
23:02:24,9,999,485,602,0,2086
23:02:25,9,999,489,601,0,2089
23:02:26,9,999,485,600,1,2085
23:02:27,9,999,492,599,1,2091
23:02:28,9,999,487,599,1,2086
23:02:29,9,999,490,598,1,2088
23:02:30,9,999,487,598,0,2084
23:02:31,9,999,489,597,1,2086
23:02:32,9,999,487,597,0,2083
23:02:33,9,999,490,596,1,2086
23:02:34,9,1000,488,595,0,2083
23:02:35,9,999,488,595,0,2082
23:02:36,9,1000,488,595,0,2083
23:02:37,9,999,489,595,1,2084
23:02:38,9,1000,488,594,1,2083
23:02:39,9,1000,487,594,0,2081
23:02:40,9,1000,487,594,0,2081
23:02:41,9,1000,491,593,1,2085
23:02:42,9,1000,485,593,0,2078
23:02:43,9,1000,488,592,1,2081
23:02:44,9,1000,488,592,1,2081
23:02:45,9,1000,486,591,1,2078
23:02:46,9,1000,488,591,1,2080
23:02:47,9,1000,486,591,1,2078
23:02:48,9,1000,489,591,0,2080
23:02:49,9,1000,490,591,0,2081
23:02:50,9,1000,488,590,0,2078
23:02:51,9,1000,485,590,1,2076
23:02:52,9,1000,485,590,0,2075
23:02:53,9,1000,490,590,1,2081
23:02:54,9,1000,487,590,1,2078
23:02:55,9,1000,486,589,0,2075
23:02:56,9,1000,476,589,1,2066
23:02:57,9,1000,489,589,1,2079
23:02:58,9,1000,487,589,0,2076
23:02:59,9,1000,490,589,1,2080
23:03:00,9,1000,485,588,1,2074
23:03:01,9,1000,483,588,0,2071
23:03:02,9,1000,494,588,1,2083
23:03:03,9,1000,489,588,1,2078
23:03:04,9,1000,492,588,1,2081
23:03:05,9,1000,488,587,0,2075
23:03:06,9,1000,490,586,0,2076
23:03:07,9,1000,488,585,1,2074
23:03:08,9,1000,488,585,1,2074
23:03:09,9,1000,484,584,1,2069
23:03:10,9,1000,492,583,1,2076
23:03:11,9,1000,487,582,1,2070
23:03:12,9,1000,486,582,0,2068
23:03:13,9,1000,490,581,0,2071
23:03:14,9,1000,488,581,1,2070
23:03:15,9,1000,487,580,1,2068
23:03:16,9,1000,483,580,1,2064
23:03:17,9,1000,487,580,0,2067
23:03:18,9,1000,490,579,1,2070
23:03:19,9,1000,492,579,0,2071
23:03:20,9,1001,487,579,1,2068
23:03:21,9,1000,487,579,1,2067
23:03:22,9,1000,489,578,1,2068
23:03:23,9,1000,487,578,1,2066
23:03:24,9,1000,488,578,0,2066
23:03:25,9,1000,488,578,0,2066
23:03:26,9,1000,486,578,0,2064
23:03:27,9,1000,490,578,0,2068
23:03:28,9,1000,489,577,1,2067
23:03:29,9,1000,490,578,2,2070
23:03:30,9,1000,488,577,1,2066
23:03:31,9,1000,489,577,0,2066
23:03:32,9,1000,487,577,1,2065
23:03:33,9,1000,486,577,1,2064
23:03:34,9,1000,491,577,1,2069
23:03:35,9,1000,484,577,1,2062
23:03:36,9,1000,486,577,0,2063
23:03:37,9,1000,490,577,1,2068
23:03:38,9,1000,485,577,1,2063
23:03:39,9,1000,488,577,1,2066
23:03:40,9,1000,489,577,1,2067
23:03:41,9,1000,486,577,0,2063
23:03:42,9,1000,489,576,1,2066
23:03:43,9,1000,445,576,1,2022
23:03:44,9,1000,490,576,1,2067
23:03:45,9,1000,487,576,0,2063
23:03:46,9,1000,485,576,0,2061
23:03:47,9,1000,491,576,1,2068
23:03:48,9,1000,487,575,0,2062
23:03:49,9,1000,489,575,1,2065
23:03:50,9,1000,484,575,0,2059
23:03:51,9,1000,492,575,1,2068
23:03:52,9,1000,490,575,0,2065
23:03:53,9,1000,486,575,0,2061
23:03:54,9,1000,488,575,1,2064
23:03:55,9,1000,487,575,1,2063
23:03:56,9,1000,488,575,1,2064
23:03:57,9,1000,486,574,1,2061
23:03:58,9,1000,487,574,1,2062
23:03:59,9,1000,489,574,1,2064
23:04:00,9,1000,488,574,0,2062
23:04:01,9,1000,486,574,1,2061
23:04:02,9,1000,488,574,1,2063
23:04:03,9,1000,485,574,1,2060
23:04:04,9,1000,488,574,1,2063
23:04:05,9,1000,489,574,0,2063
23:04:06,9,1000,489,574,1,2064
23:04:07,9,1000,485,574,1,2060
23:04:08,9,1000,489,574,0,2063
23:04:09,9,999,490,573,0,2062
23:04:10,9,1000,489,573,1,2063
23:04:11,9,1000,485,573,1,2059
23:04:12,9,1000,489,573,0,2062
23:04:13,9,1000,485,573,0,2058
23:04:14,9,1000,487,573,1,2061
23:04:15,9,1000,488,573,1,2062
23:04:16,9,1000,489,573,1,2063
23:04:17,9,1000,488,573,1,2062
23:04:18,9,1000,491,572,0,2063
23:04:19,9,1000,488,572,0,2060
23:04:20,9,999,488,572,0,2059
23:04:21,9,999,489,572,1,2061
23:04:22,9,1000,485,572,0,2057
23:04:23,9,999,489,572,0,2060
23:04:24,9,1000,488,572,0,2060
23:04:25,9,999,487,572,1,2059
23:04:26,9,999,489,572,1,2061
23:04:27,9,999,489,572,0,2060
23:04:28,9,999,487,572,0,2058
23:04:29,9,999,486,572,0,2057
23:04:30,9,999,490,571,0,2060
23:04:31,9,999,489,571,1,2060
23:04:32,9,999,488,571,1,2059
23:04:33,9,999,491,571,0,2061
23:04:34,9,999,489,571,0,2059
23:04:35,9,999,491,571,1,2062
23:04:36,9,999,488,571,1,2059
23:04:37,9,999,487,571,1,2058
23:04:38,9,999,491,571,0,2061
23:04:39,9,999,487,571,2,2059
23:04:40,9,999,488,571,0,2058
23:04:41,9,999,488,570,0,2057
23:04:42,9,999,489,570,1,2059
23:04:43,9,999,485,570,1,2055
23:04:44,9,999,490,570,1,2060
23:04:45,9,998,488,569,1,2056
23:04:46,9,998,486,569,1,2054
23:04:47,9,998,489,569,1,2057
23:04:48,9,998,491,569,0,2058
23:04:49,9,998,487,568,0,2053
23:04:50,9,998,488,568,0,2054
23:04:51,9,998,485,568,0,2051
23:04:52,9,998,484,568,1,2051
23:04:53,9,998,487,568,0,2053
23:04:54,9,998,487,567,0,2052
23:04:55,9,998,490,567,0,2055
23:04:56,9,999,488,567,0,2054
23:04:57,9,998,489,567,0,2054
23:04:58,9,998,488,567,1,2054
23:04:59,9,998,485,567,0,2050
23:05:00,9,998,487,567,1,2053
23:05:01,9,998,490,567,1,2056
23:05:02,9,998,487,567,1,2053
23:05:03,9,998,489,567,1,2055
23:05:04,9,998,488,567,1,2054
23:05:05,9,998,487,567,1,2053
23:05:06,9,998,489,567,1,2055
23:05:07,9,998,488,566,0,2052
23:05:08,9,998,489,566,1,2054
23:05:09,9,998,490,566,1,2055
23:05:10,9,998,488,566,0,2052
23:05:11,9,999,488,566,0,2053
23:05:12,9,998,490,566,1,2055
23:05:13,9,998,486,566,0,2050
23:05:14,9,998,488,566,1,2053
23:05:15,9,998,487,566,1,2052
23:05:16,9,998,488,566,0,2052
23:05:17,9,998,487,565,1,2051
23:05:18,9,998,485,565,0,2048
23:05:19,9,998,487,565,1,2051
23:05:20,9,998,488,565,1,2052
23:05:21,9,998,492,565,1,2056
23:05:22,9,998,488,565,0,2051
23:05:23,9,998,489,565,1,2053
23:05:24,9,998,486,564,1,2049
23:05:25,9,998,488,564,1,2051
23:05:26,9,998,488,564,1,2051
23:05:27,9,998,490,564,0,2052
23:05:28,9,998,491,563,1,2053
23:05:29,9,998,491,563,1,2053
23:05:30,9,999,488,563,0,2050
23:05:31,9,998,491,563,0,2052
23:05:32,9,998,489,563,1,2051
23:05:33,9,999,488,563,0,2050
23:05:34,9,998,488,563,0,2049
23:05:35,9,998,487,562,1,2048
23:05:36,9,999,487,562,0,2048
23:05:37,9,998,487,562,1,2048
23:05:38,9,998,489,562,0,2049
23:05:39,9,998,488,562,1,2049
23:05:40,9,998,486,562,0,2046
23:05:41,9,998,489,562,0,2049
23:05:42,9,999,489,562,0,2050
23:05:43,9,998,484,562,1,2045
23:05:44,9,998,485,562,1,2046
23:05:45,9,999,488,562,1,2050
23:05:46,9,998,491,562,0,2051
23:05:47,9,998,490,562,0,2050
23:05:48,9,999,489,561,1,2050
23:05:49,9,998,488,561,1,2048
23:05:50,9,998,489,561,1,2049
23:05:51,9,998,487,561,1,2047
23:05:52,9,998,488,560,0,2046
23:05:53,9,999,489,560,1,2049
23:05:54,9,998,487,560,1,2046
23:05:55,9,998,489,560,1,2048
23:05:56,9,998,489,560,1,2048
23:05:57,9,999,489,560,1,2049
23:05:58,9,999,490,560,0,2049
23:05:59,9,999,489,560,1,2049
23:06:00,9,998,487,560,1,2046
23:06:01,9,998,486,559,0,2043
23:06:02,9,999,491,559,0,2049
23:06:03,9,998,484,559,0,2041
23:06:04,9,999,489,559,1,2048
23:06:05,9,998,490,558,0,2046
23:06:06,9,999,488,558,1,2046
23:06:07,9,998,486,558,1,2043
23:06:08,9,998,485,558,1,2042
23:06:09,9,998,497,557,1,2053
23:06:10,9,998,488,557,0,2043
23:06:11,9,999,482,557,1,2039
23:06:12,9,998,492,557,0,2047
23:06:13,9,998,485,556,1,2040
23:06:14,9,998,488,556,0,2042
23:06:15,9,998,485,556,1,2040
23:06:16,9,998,488,556,0,2042
23:06:17,9,0,0,0,0,0
23:06:18,9,999,486,556,1,2042
23:06:19,9,998,487,556,2,2043
23:06:20,9,998,488,556,1,2043
23:06:21,9,998,490,556,1,2045
23:06:22,9,998,488,556,1,2043
23:06:23,9,998,487,556,0,2041
23:06:24,9,998,488,556,1,2043
23:06:25,9,998,490,556,0,2044
23:06:26,9,998,489,555,1,2043
23:06:27,9,998,487,555,0,2040
23:06:28,9,998,465,555,1,2019
23:06:29,9,998,488,555,1,2042
23:06:30,9,998,489,555,1,2043
23:06:31,9,998,486,554,0,2038
23:06:32,9,998,486,554,0,2038
23:06:33,9,998,489,554,0,2041
23:06:34,9,998,489,554,1,2042
23:06:35,9,998,489,555,1,2043
23:06:36,9,998,483,555,0,2036
23:06:37,9,998,490,555,1,2044
23:06:38,9,998,490,555,0,2043
23:06:39,9,998,488,554,0,2040
23:06:40,9,998,487,554,1,2040
23:06:41,9,998,492,554,1,2045
23:06:42,9,998,484,554,1,2037
23:06:43,9,998,488,554,0,2040
23:06:44,9,998,488,553,1,2040
23:06:45,9,998,479,553,0,2030
23:06:46,9,998,485,553,0,2036
23:06:47,9,998,493,553,0,2044
23:06:48,9,998,487,553,1,2039
23:06:49,9,998,490,553,0,2041
23:06:50,9,998,489,552,1,2040
23:06:51,9,998,491,552,1,2042
23:06:52,9,998,493,552,0,2043
23:06:53,9,998,492,552,1,2043
23:06:54,9,998,506,552,1,2057
23:06:55,9,998,488,552,1,2039
23:06:56,9,998,485,552,0,2035
23:06:57,9,998,486,553,1,2038
23:06:58,9,998,485,553,1,2037
23:06:59,9,998,488,553,1,2040
23:07:00,9,998,487,552,1,2038
23:07:01,9,998,489,552,0,2039
23:07:02,9,998,487,552,0,2037
23:07:03,9,998,490,552,0,2040
23:07:04,9,998,487,553,0,2038
23:07:05,9,999,488,554,0,2041
22:50:41,10,1000,486,530,0,2016
22:50:42,10,999,597,530,0,2126
22:50:43,10,999,517,530,0,2046
22:50:44,10,999,493,530,0,2022
22:50:45,10,1000,479,530,0,2009
22:50:46,10,999,500,530,0,2029
22:50:47,10,999,499,530,0,2028
22:50:48,10,999,504,531,0,2034
22:50:49,10,999,490,531,0,2020
22:50:50,10,999,512,531,0,2042
22:50:51,10,999,489,531,0,2019
22:50:52,10,999,491,531,0,2021
22:50:53,10,999,502,531,0,2032
22:50:54,10,0,0,0,0,0
22:50:55,10,998,511,531,0,2040
22:50:56,10,998,506,531,0,2035
22:50:57,10,997,472,531,0,2000
22:50:58,10,998,497,530,0,2025
22:50:59,10,998,446,531,0,1975
22:51:00,10,999,498,531,0,2028
22:51:01,10,1008,489,531,0,2028
22:51:02,10,1012,484,535,0,2031
22:51:03,10,998,480,533,0,2011
22:51:04,10,0,0,0,0,0
22:51:05,10,1006,500,533,0,2039
22:51:06,10,1004,389,537,0,1930
22:51:07,10,997,533,535,0,2065
22:51:08,10,997,491,534,0,2022
22:51:09,10,1004,480,534,0,2018
22:51:10,10,1012,491,538,0,2041
22:51:11,10,1000,495,537,0,2032
22:51:12,10,999,498,536,0,2033
22:51:13,10,999,491,535,0,2025
22:51:14,10,999,488,535,0,2022
22:51:15,10,999,496,535,0,2030
22:51:16,10,0,0,0,0,0
22:51:17,10,0,0,0,0,0
22:51:18,10,0,0,0,0,0
22:51:19,10,0,0,0,0,0
22:51:20,10,0,0,0,0,0
22:51:21,10,0,0,0,0,0
22:51:22,10,0,0,0,0,0
22:51:23,10,0,0,0,0,0
22:51:24,10,0,0,0,0,0
22:51:25,10,998,0,534,0,1532
22:51:26,10,997,509,534,0,2040
22:51:27,10,0,0,0,0,0
22:51:28,10,997,500,533,0,2030
22:51:29,10,0,0,0,0,0
22:51:30,10,996,244,533,0,1773
22:51:31,10,0,0,0,0,0
22:51:32,10,0,0,0,0,0
22:51:33,10,0,0,0,0,0
22:51:34,10,997,566,533,0,2096
22:51:35,10,0,0,0,0,0
22:51:36,10,0,0,0,0,0
22:51:37,10,998,500,533,0,2031
22:51:38,10,998,488,533,137,2156
22:51:39,10,998,493,533,8,2032
22:51:40,10,0,0,0,0,0
22:51:41,10,1000,489,534,401,2424
22:51:42,10,0,0,0,0,0
22:51:43,10,0,0,0,0,0
22:51:44,10,999,488,533,459,2479
22:51:45,10,0,0,0,0,0
22:51:46,10,0,0,0,0,0
22:51:47,10,999,488,533,532,2552
22:51:48,10,999,496,533,547,2575
22:51:49,10,1000,503,533,502,2538
22:51:50,10,1000,504,532,541,2577
22:51:51,10,999,483,532,370,2384
22:51:52,10,999,496,532,326,2353
22:51:53,10,0,0,0,0,0
22:51:54,10,1000,505,535,527,2567
22:51:55,10,1001,480,536,282,2299
22:51:56,10,1000,490,537,413,2440
22:51:57,10,1005,514,545,399,2463
22:51:58,10,1000,494,565,472,2531
22:51:59,10,0,0,0,0,0
22:52:00,10,1001,546,573,490,2610
22:52:01,10,1002,482,575,649,2708
22:52:02,10,1001,490,582,503,2576
22:52:03,10,1001,501,582,558,2642
22:52:04,10,1001,490,588,407,2486
22:52:05,10,1001,489,595,561,2646
22:52:06,10,1000,486,598,526,2610
22:52:07,10,1000,496,599,418,2513
22:52:08,10,1000,496,599,424,2519
22:52:09,10,1000,511,601,622,2734
22:52:10,10,1000,505,600,287,2392
22:52:11,10,0,0,0,0,0
22:52:12,10,0,0,0,0,0
22:52:13,10,0,0,0,0,0
22:52:14,10,1000,523,604,576,2703
22:52:15,10,1000,499,608,482,2589
22:52:16,10,1000,503,609,504,2616
22:52:17,10,1000,475,609,567,2651
22:52:18,10,1000,495,609,363,2467
22:52:19,10,1000,490,610,431,2531
22:52:20,10,999,508,608,425,2540
22:52:21,10,1000,500,607,402,2509
22:52:22,10,1000,494,605,525,2624
22:52:23,10,999,484,604,559,2646
22:52:24,10,1000,491,604,611,2706
22:52:25,10,1000,492,603,524,2619
22:52:26,10,999,474,601,535,2609
22:52:27,10,1000,490,601,536,2627
22:52:28,10,1000,520,601,456,2577
22:52:29,10,999,495,602,548,2644
22:52:30,10,999,500,608,501,2608
22:52:31,10,999,500,608,467,2574
22:52:32,10,999,499,608,509,2615
22:52:33,10,999,459,607,882,2947
22:52:34,10,999,515,606,847,2967
22:52:35,10,999,512,606,882,2999
22:52:36,10,999,487,604,820,2910
22:52:37,10,1000,497,604,933,3034
22:52:38,10,999,497,604,844,2944
22:52:39,10,999,492,602,885,2978
22:52:40,10,999,491,601,919,3010
22:52:41,10,999,475,600,836,2910
22:52:42,10,0,0,0,0,0
22:52:43,10,999,506,598,867,2970
22:52:44,10,999,497,597,859,2952
22:52:45,10,999,501,596,828,2924
22:52:46,10,999,500,595,834,2928
22:52:47,10,999,478,594,871,2942
22:52:48,10,999,492,594,860,2945
22:52:49,10,999,492,593,862,2946
22:52:50,10,999,516,593,865,2973
22:52:51,10,999,500,602,892,2993
22:52:52,10,999,477,599,902,2977
22:52:53,10,999,485,600,872,2956
22:52:54,10,999,460,598,920,2977
22:52:55,10,0,0,0,0,0
22:52:56,10,999,490,597,953,3039
22:52:57,10,999,545,596,849,2989
22:52:58,10,999,490,595,860,2944
22:52:59,10,999,479,595,843,2916
22:53:00,10,999,447,596,807,2849
22:53:01,10,999,509,595,826,2929
22:53:02,10,0,0,0,0,0
22:53:03,10,0,0,0,0,0
22:53:04,10,999,504,596,876,2975
22:53:05,10,999,500,600,834,2933
22:53:06,10,0,0,0,0,0
22:53:07,10,999,490,599,870,2958
22:53:08,10,999,489,600,854,2942
22:53:09,10,1000,500,602,865,2967
22:53:10,10,1000,493,607,923,3023
22:53:11,10,1001,497,608,994,3100
22:53:12,10,1000,502,614,881,2997
22:53:13,10,1000,488,614,830,2932
22:53:14,10,1000,490,614,913,3017
22:53:15,10,999,491,615,873,2978
22:53:16,10,999,492,616,844,2951
22:53:17,10,999,493,616,901,3009
22:53:18,10,999,487,617,946,3049
22:53:19,10,999,502,617,895,3013
22:53:20,10,999,496,616,901,3012
22:53:21,10,999,496,617,904,3016
22:53:22,10,999,500,617,910,3026
22:53:23,10,999,486,618,915,3018
22:53:24,10,999,491,619,756,2865
22:53:25,10,999,490,618,856,2963
22:53:26,10,999,496,618,835,2948
22:53:27,10,999,487,618,896,3000
22:53:28,10,999,495,618,898,3010
22:53:29,10,999,497,619,875,2990
22:53:30,10,999,493,619,862,2973
22:53:31,10,999,495,618,867,2979
22:53:32,10,999,489,618,861,2967
22:53:33,10,999,491,617,932,3039
22:53:34,10,999,493,617,964,3073
22:53:35,10,999,496,617,905,3017
22:53:36,10,999,496,618,823,2936
22:53:37,10,1001,494,622,852,2969
22:53:38,10,1000,494,625,872,2991
22:53:39,10,999,494,627,871,2991
22:53:40,10,999,494,625,917,3035
22:53:41,10,999,493,625,918,3035
22:53:42,10,999,491,625,851,2966
22:53:43,10,999,485,625,856,2965
22:53:44,10,999,494,623,937,3053
22:53:45,10,998,494,623,864,2979
22:53:46,10,999,494,622,908,3023
22:53:47,10,999,490,621,934,3044
22:53:48,10,999,488,621,881,2989
22:53:49,10,999,492,620,879,2990
22:53:50,10,999,492,620,863,2974
22:53:51,10,0,0,0,0,0
22:53:52,10,1000,510,619,804,2933
22:53:53,10,999,488,617,870,2974
22:53:54,10,999,493,617,874,2983
22:53:55,10,999,494,616,849,2958
22:53:56,10,999,495,615,957,3066
22:53:57,10,999,495,614,869,2977
22:53:58,10,999,490,614,901,3004
22:53:59,10,999,496,613,845,2953
22:54:00,10,999,499,612,853,2963
22:54:01,10,999,492,610,849,2950
22:54:02,10,999,488,609,907,3003
22:54:03,10,1000,467,609,757,2833
22:54:04,10,1000,497,607,786,2890
22:54:05,10,999,493,607,840,2939
22:54:06,10,999,495,606,878,2978
22:54:07,10,1000,490,605,874,2969
22:54:08,10,1000,498,605,866,2969
22:54:09,10,1000,487,605,865,2957
22:54:10,10,999,495,604,866,2964
22:54:11,10,999,499,603,811,2912
22:54:12,10,999,487,602,832,2920
22:54:13,10,1000,496,602,931,3029
22:54:14,10,999,489,602,837,2927
22:54:15,10,999,507,603,892,3001
22:54:16,10,999,486,604,889,2978
22:54:17,10,1000,486,605,837,2928
22:54:18,10,999,497,606,853,2955
22:54:19,10,999,487,607,902,2995
22:54:20,10,999,498,608,833,2938
22:54:21,10,999,480,608,879,2966
22:54:22,10,999,502,609,872,2982
22:54:23,10,1000,497,609,941,3047
22:54:24,10,999,491,610,922,3022
22:54:25,10,1000,500,611,872,2983
22:54:26,10,999,490,611,921,3021
22:54:27,10,999,486,610,800,2895
22:54:28,10,999,495,609,897,3000
22:54:29,10,999,495,608,889,2991
22:54:30,10,1000,495,609,887,2991
22:54:31,10,0,0,0,0,0
22:54:32,10,999,478,607,997,3081
22:54:33,10,999,497,606,841,2943
22:54:34,10,999,489,605,877,2970
22:54:35,10,999,481,605,915,3000
22:54:36,10,999,491,604,948,3042
22:54:37,10,999,490,602,899,2990
22:54:38,10,999,501,601,902,3003
22:54:39,10,1000,491,601,767,2859
22:54:40,10,999,487,600,904,2990
22:54:41,10,999,488,600,854,2941
22:54:42,10,999,480,600,922,3001
22:54:43,10,999,490,599,858,2946
22:54:44,10,999,485,599,843,2926
22:54:45,10,999,501,599,769,2868
22:54:46,10,999,496,598,950,3043
22:54:47,10,999,497,598,931,3025
22:54:48,10,999,490,597,930,3016
22:54:49,10,999,492,596,837,2924
22:54:50,10,999,490,596,865,2950
22:54:51,10,999,497,595,915,3006
22:54:52,10,999,492,594,839,2924
22:54:53,10,1000,489,600,923,3012
22:54:54,10,999,490,599,902,2990
22:54:55,10,999,495,599,903,2996
22:54:56,10,998,496,599,861,2954
22:54:57,10,998,496,598,852,2944
22:54:58,10,997,492,598,836,2923
22:54:59,10,998,487,598,884,2967
22:55:00,10,999,505,598,979,3081
22:55:01,10,999,500,598,822,2919
22:55:02,10,1000,498,598,899,2995
22:55:03,10,999,492,597,828,2916
22:55:04,10,999,499,597,905,3000
22:55:05,10,1000,501,597,828,2926
22:55:06,10,1000,495,597,878,2970
22:55:07,10,0,0,0,0,0
22:55:08,10,1000,493,596,908,2997
22:55:09,10,1000,498,596,796,2890
22:55:10,10,1000,487,596,909,2992
22:55:11,10,1000,481,595,880,2956
22:55:12,10,1000,494,595,879,2968
22:55:13,10,1000,493,595,837,2925
22:55:14,10,1000,491,595,872,2958
22:55:15,10,0,0,0,0,0
22:55:16,10,1000,491,595,859,2945
22:55:17,10,1000,501,595,892,2988
22:55:18,10,1000,496,594,839,2929
22:55:19,10,1000,490,593,814,2897
22:55:20,10,0,0,0,0,0
22:55:21,10,1000,491,596,877,2964
22:55:22,10,1000,486,597,844,2927
22:55:23,10,1000,486,597,861,2944
22:55:24,10,1000,499,599,873,2971
22:55:25,10,1000,496,597,888,2981
22:55:26,10,1000,493,597,828,2918
22:55:27,10,1000,507,597,895,2999
22:55:28,10,1000,504,597,854,2955
22:55:29,10,1000,498,595,873,2966
22:55:30,10,1000,485,594,882,2961
22:55:31,10,0,0,0,0,0
22:55:32,10,1000,505,592,937,3034
22:55:33,10,999,499,592,855,2945
22:55:34,10,1000,499,590,884,2973
22:55:35,10,999,495,589,886,2969
22:55:36,10,999,510,588,836,2933
22:55:37,10,1000,500,588,836,2924
22:55:38,10,999,493,587,880,2959
22:55:39,10,1000,499,587,868,2954
22:55:40,10,1000,497,587,932,3016
22:55:41,10,1000,495,586,897,2978
22:55:42,10,999,485,585,915,2984
22:55:43,10,999,502,584,867,2952
22:55:44,10,1000,477,584,924,2985
22:55:45,10,1000,489,583,812,2884
22:55:46,10,1000,478,582,936,2996
22:55:47,10,1000,501,582,892,2975
22:55:48,10,1000,486,581,819,2886
22:55:49,10,1000,490,581,961,3032
22:55:50,10,1000,488,580,898,2966
22:55:51,10,999,487,579,846,2911
22:55:52,10,1000,494,578,928,3000
22:55:53,10,1000,480,578,829,2887
22:55:54,10,999,499,577,865,2940
22:55:55,10,1000,494,576,772,2842
22:55:56,10,1000,494,576,822,2892
22:55:57,10,999,484,575,927,2985
22:55:58,10,1000,498,575,949,3022
22:55:59,10,1000,490,575,886,2951
22:56:00,10,1000,483,575,876,2934
22:56:01,10,1000,499,575,829,2903
22:56:02,10,1000,496,574,838,2908
22:56:03,10,1000,500,574,805,2879
22:56:04,10,999,494,574,850,2917
22:56:05,10,1000,484,574,962,3020
22:56:06,10,999,488,573,760,2820
22:56:07,10,999,489,573,952,3013
22:56:08,10,999,492,572,841,2904
22:56:09,10,999,490,572,877,2938
22:56:10,10,999,499,572,805,2875
22:56:11,10,0,0,0,0,0
22:56:12,10,999,491,572,771,2833
22:56:13,10,999,492,571,884,2946
22:56:14,10,999,495,571,887,2952
22:56:15,10,999,488,572,869,2928
22:56:16,10,999,501,571,912,2983
22:56:17,10,999,487,571,860,2917
22:56:18,10,999,501,572,471,2543
22:56:19,10,999,481,572,459,2511
22:56:20,10,999,493,572,405,2469
22:56:21,10,0,0,0,0,0
22:56:22,10,999,497,574,541,2611
22:56:23,10,999,498,574,652,2723
22:56:24,10,999,489,575,500,2563
22:56:25,10,999,493,575,682,2749
22:56:26,10,999,490,575,472,2536
22:56:27,10,999,486,576,647,2708
22:56:28,10,1000,484,576,330,2390
22:56:29,10,999,493,577,501,2570
22:56:30,10,999,491,578,481,2549
22:56:31,10,999,488,578,511,2576
22:56:32,10,999,487,578,565,2629
22:56:33,10,1000,492,579,552,2623
22:56:34,10,1000,494,579,507,2580
22:56:35,10,1000,490,578,589,2657
22:56:36,10,1000,497,578,500,2575
22:56:37,10,1000,487,579,383,2449
22:56:38,10,1000,490,579,542,2611
22:56:39,10,1000,498,579,563,2640
22:56:40,10,999,492,580,431,2502
22:56:41,10,1000,496,580,409,2485
22:56:42,10,1000,490,580,513,2583
22:56:43,10,1000,491,581,589,2661
22:56:44,10,999,493,581,620,2693
22:56:45,10,999,493,581,546,2619
22:56:46,10,999,486,582,549,2616
22:56:47,10,999,490,583,488,2560
22:56:48,10,1000,498,585,301,2384
22:56:49,10,999,492,586,486,2563
22:56:50,10,999,493,586,509,2587
22:56:51,10,1000,490,587,606,2683
22:56:52,10,999,498,587,565,2649
22:56:53,10,999,493,587,551,2630
22:56:54,10,999,492,587,454,2532
22:56:55,10,999,491,587,584,2661
22:56:56,10,999,496,588,554,2637
22:56:57,10,999,486,588,592,2665
22:56:58,10,999,499,588,576,2662
22:56:59,10,999,495,587,942,3023
22:57:00,10,999,498,588,874,2959
22:57:01,10,999,498,588,886,2971
22:57:02,10,999,499,587,863,2948
22:57:03,10,999,496,588,931,3014
22:57:04,10,999,498,588,968,3053
22:57:05,10,999,495,587,859,2940
22:57:06,10,999,500,587,894,2980
22:57:07,10,999,493,587,932,3011
22:57:08,10,999,494,587,927,3007
22:57:09,10,999,487,587,886,2959
22:57:10,10,999,492,586,854,2931
22:57:11,10,999,492,586,886,2963
22:57:12,10,999,502,586,882,2969
22:57:13,10,999,489,585,883,2956
22:57:14,10,999,500,585,912,2996
22:57:15,10,1000,501,585,855,2941
22:57:16,10,999,490,584,897,2970
22:57:17,10,999,496,584,922,3001
22:57:18,10,999,488,583,890,2960
22:57:19,10,1000,492,582,946,3020
22:57:20,10,1000,487,582,308,2377
22:57:21,10,999,497,582,473,2551
22:57:22,10,999,495,581,477,2552
22:57:23,10,999,496,582,547,2624
22:57:24,10,999,491,581,721,2792
22:57:25,10,998,492,580,368,2438
22:57:26,10,998,485,580,480,2543
22:57:27,10,997,499,579,512,2587
22:57:28,10,998,477,579,562,2616
22:57:29,10,998,501,578,474,2551
22:57:30,10,998,492,578,496,2564
22:57:31,10,998,487,578,453,2516
22:57:32,10,998,492,578,408,2476
22:57:33,10,998,496,578,509,2581
22:57:34,10,998,493,577,405,2473
22:57:35,10,998,493,578,442,2511
22:57:36,10,998,490,578,595,2661
22:57:37,10,998,495,578,412,2483
22:57:38,10,998,500,578,405,2481
22:57:39,10,998,486,579,551,2614
22:57:40,10,998,467,579,479,2523
22:57:41,10,998,494,579,409,2480
22:57:42,10,0,0,0,0,0
22:57:43,10,998,498,588,528,2612
22:57:44,10,0,0,0,0,0
22:57:45,10,999,495,591,413,2498
22:57:46,10,999,487,591,546,2623
22:57:47,10,998,496,589,465,2548
22:57:48,10,998,487,589,460,2534
22:57:49,10,999,498,588,514,2599
22:57:50,10,998,483,588,475,2544
22:57:51,10,998,493,587,537,2615
22:57:52,10,999,481,587,354,2421
22:57:53,10,998,490,585,499,2572
22:57:54,10,998,447,583,567,2595
22:57:55,10,999,422,583,336,2340
22:57:56,10,998,498,583,329,2408
22:57:57,10,998,499,582,505,2584
22:57:58,10,998,479,580,454,2511
22:57:59,10,999,539,579,408,2525
22:58:00,10,999,490,579,546,2614
22:58:01,10,998,504,578,577,2657
22:58:02,10,998,490,578,873,2939
22:58:03,10,999,509,577,887,2972
22:58:04,10,999,495,576,942,3012
22:58:05,10,999,487,576,878,2940
22:58:06,10,999,487,575,931,2992
22:58:07,10,998,490,574,929,2991
22:58:08,10,999,493,574,906,2972
22:58:09,10,999,492,574,843,2908
22:58:10,10,999,496,574,938,3007
22:58:11,10,999,491,573,913,2976
22:58:12,10,999,492,573,900,2964
22:58:13,10,999,493,573,900,2965
22:58:14,10,999,504,573,926,3002
22:58:15,10,998,488,573,876,2935
22:58:16,10,0,0,0,0,0
22:58:17,10,999,490,574,855,2918
22:58:18,10,999,491,574,945,3009
22:58:19,10,998,489,573,898,2958
22:58:20,10,998,493,573,867,2931
22:58:21,10,999,492,574,888,2953
22:58:22,10,999,493,574,898,2964
22:58:23,10,999,490,574,882,2945
22:58:24,10,999,491,574,900,2964
22:58:25,10,999,481,574,907,2961
22:58:26,10,999,493,573,890,2955
22:58:27,10,999,496,573,906,2974
22:58:28,10,999,489,573,958,3019
22:58:29,10,999,488,573,831,2891
22:58:30,10,999,499,572,888,2958
22:58:31,10,999,492,572,926,2989
22:58:32,10,999,491,572,921,2983
22:58:33,10,999,493,571,922,2985
22:58:34,10,0,0,0,0,0
22:58:35,10,999,491,570,439,2499
22:58:36,10,999,496,570,471,2536
22:58:37,10,999,488,569,621,2677
22:58:38,10,999,491,569,519,2578
22:58:39,10,1000,486,568,435,2489
22:58:40,10,999,489,568,528,2584
22:58:41,10,999,492,567,550,2608
22:58:42,10,999,490,567,469,2525
22:58:43,10,999,493,567,568,2627
22:58:44,10,999,505,566,434,2504
22:58:45,10,999,498,566,404,2467
22:58:46,10,999,492,565,465,2521
22:58:47,10,999,496,565,661,2721
22:58:48,10,999,493,564,423,2479
22:58:49,10,999,493,564,447,2503
22:58:50,10,999,492,564,523,2578
22:58:51,10,1000,499,563,489,2551
22:58:52,10,999,489,563,492,2543
22:58:53,10,999,486,563,872,2920
22:58:54,10,999,493,564,906,2962
22:58:55,10,999,492,566,850,2907
22:58:56,10,999,485,567,903,2954
22:58:57,10,999,493,568,861,2921
22:58:58,10,999,494,570,898,2961
22:58:59,10,998,483,573,887,2941
22:59:00,10,997,488,579,888,2952
22:59:01,10,997,498,584,875,2954
22:59:02,10,0,0,0,0,0
22:59:03,10,998,494,586,897,2975
22:59:04,10,998,496,588,887,2969
22:59:05,10,998,491,587,875,2951
22:59:06,10,998,494,586,872,2950
22:59:07,10,998,496,586,950,3030
22:59:08,10,999,492,585,862,2938
22:59:09,10,999,497,584,884,2964
22:59:10,10,0,0,0,0,0
22:59:11,10,999,494,583,885,2961
22:59:12,10,999,493,582,887,2961
22:59:13,10,999,494,581,918,2992
22:59:14,10,1000,496,580,993,3069
22:59:15,10,999,502,580,897,2978
22:59:16,10,999,486,579,843,2907
22:59:17,10,999,492,578,923,2992
22:59:18,10,999,495,577,875,2946
22:59:19,10,999,495,577,873,2944
22:59:20,10,999,489,576,929,2993
22:59:21,10,999,493,576,899,2967
22:59:22,10,999,498,576,827,2900
22:59:23,10,999,489,575,917,2980
22:59:24,10,999,493,575,905,2972
22:59:25,10,999,495,575,866,2935
22:59:26,10,999,508,575,882,2964
22:59:27,10,999,483,575,962,3019
22:59:28,10,999,488,574,842,2903
22:59:29,10,0,0,0,0,0
22:59:30,10,998,506,573,876,2953
22:59:31,10,999,390,573,906,2868
22:59:32,10,998,495,572,948,3013
22:59:33,10,999,493,571,888,2951
22:59:34,10,999,503,571,889,2962
22:59:35,10,1001,511,570,899,2981
22:59:36,10,1001,519,570,845,2935
22:59:37,10,1000,499,570,884,2953
22:59:38,10,1001,479,569,936,2985
22:59:39,10,1000,576,569,907,3052
22:59:40,10,999,484,568,869,2920
22:59:41,10,999,490,567,854,2910
22:59:42,10,999,516,567,914,2996
22:59:43,10,999,495,566,837,2897
22:59:44,10,999,411,566,927,2903
22:59:45,10,998,516,566,910,2990
22:59:46,10,998,480,566,909,2953
22:59:47,10,998,482,566,913,2959
22:59:48,10,997,610,566,920,3093
22:59:49,10,998,476,565,923,2962
22:59:50,10,998,476,565,897,2936
22:59:51,10,999,471,566,868,2904
22:59:52,10,1000,560,566,898,3024
22:59:53,10,1000,498,565,885,2948
22:59:54,10,1004,493,565,891,2953
22:59:55,10,1000,494,565,882,2941
22:59:56,10,1000,483,565,924,2972
22:59:57,10,1000,498,564,873,2935
22:59:58,10,1000,500,564,929,2993
22:59:59,10,1000,494,564,888,2946
23:00:00,10,1000,496,564,864,2924
23:00:01,10,1000,489,565,865,2919
23:00:02,10,1000,497,565,861,2923
23:00:03,10,1000,494,565,900,2959
23:00:04,10,1000,487,565,953,3005
23:00:05,10,999,487,565,902,2953
23:00:06,10,1000,482,565,897,2944
23:00:07,10,1000,494,565,883,2942
23:00:08,10,1000,488,565,901,2954
23:00:09,10,1000,498,565,929,2992
23:00:10,10,1000,494,565,888,2947
23:00:11,10,1000,502,565,920,2987
23:00:12,10,1000,492,565,875,2932
23:00:13,10,1000,476,565,866,2907
23:00:14,10,1000,499,567,878,2944
23:00:15,10,1000,489,568,846,2903
23:00:16,10,1000,495,568,904,2967
23:00:17,10,1000,489,567,859,2915
23:00:18,10,1000,485,567,927,2979
23:00:19,10,1000,494,567,931,2992
23:00:20,10,1000,488,567,843,2898
23:00:21,10,1000,562,567,857,2986
23:00:22,10,1000,494,567,931,2992
23:00:23,10,1001,477,568,889,2935
23:00:24,10,1000,490,568,876,2934
23:00:25,10,1000,492,568,906,2966
23:00:26,10,1000,475,568,908,2951
23:00:27,10,1000,493,568,915,2976
23:00:28,10,1000,492,568,914,2974
23:00:29,10,1000,492,568,913,2973
23:00:30,10,1000,497,568,897,2962
23:00:31,10,1000,497,568,934,2999
23:00:32,10,1000,493,568,872,2933
23:00:33,10,1000,491,568,821,2880
23:00:34,10,1000,497,567,883,2947
23:00:35,10,1000,492,567,909,2968
23:00:36,10,1000,497,566,843,2906
23:00:37,10,1000,506,566,895,2967
23:00:38,10,1000,489,565,934,2988
23:00:39,10,1001,500,565,935,3001
23:00:40,10,1000,493,565,934,2992
23:00:41,10,0,0,0,0,0
23:00:42,10,1000,492,564,952,3008
23:00:43,10,0,0,0,0,0
23:00:44,10,1000,493,564,958,3015
23:00:45,10,1000,492,564,973,3029
23:00:46,10,1000,495,564,938,2997
23:00:47,10,999,490,563,949,3001
23:00:48,10,1000,495,562,976,3033
23:00:49,10,999,490,562,957,3008
23:00:50,10,1000,486,562,969,3017
23:00:51,10,1001,507,562,979,3049
23:00:52,10,1000,489,562,980,3031
23:00:53,10,1001,499,561,931,2992
23:00:54,10,1001,495,560,967,3023
23:00:55,10,1000,500,560,957,3017
23:00:56,10,1000,498,562,947,3007
23:00:57,10,1000,493,563,931,2987
23:00:58,10,1000,488,563,139,2190
23:00:59,10,1000,499,563,143,2205
23:01:00,10,1000,484,563,144,2191
23:01:01,10,999,499,563,177,2238
23:01:02,10,1000,495,564,120,2179
23:01:03,10,1000,490,564,163,2217
23:01:04,10,999,489,564,136,2188
23:01:05,10,999,491,564,101,2155
23:01:06,10,999,504,564,118,2185
23:01:07,10,1000,496,564,69,2129
23:01:08,10,1000,493,563,133,2189
23:01:09,10,999,494,563,99,2155
23:01:10,10,999,485,563,177,2224
23:01:11,10,999,495,563,60,2117
23:01:12,10,999,504,563,77,2143
23:01:13,10,999,508,562,181,2250
23:01:14,10,1000,495,562,34,2091
23:01:15,10,999,502,562,189,2252
23:01:16,10,999,491,562,118,2170
23:01:17,10,999,498,562,111,2170
23:01:18,10,999,484,561,116,2160
23:01:19,10,999,499,561,3,2062
23:01:20,10,999,496,561,2,2058
23:01:21,10,999,489,560,2,2050
23:01:22,10,0,0,0,0,0
23:01:23,10,999,493,560,2,2054
23:01:24,10,999,491,560,2,2052
23:01:25,10,999,503,559,2,2063
23:01:26,10,999,493,559,1,2052
23:01:27,10,999,495,559,2,2055
23:01:28,10,999,496,559,3,2057
23:01:29,10,999,488,559,5,2051
23:01:30,10,999,491,559,2,2051
23:01:31,10,1000,490,559,5,2054
23:01:32,10,999,491,558,2,2050
23:01:33,10,999,490,558,2,2049
23:01:34,10,999,489,558,1,2047
23:01:35,10,999,499,557,1,2056
23:01:36,10,999,494,557,2,2052
23:01:37,10,999,508,557,3,2067
23:01:38,10,999,495,557,2,2053
23:01:39,10,999,493,557,1,2050
23:01:40,10,999,489,556,3,2047
23:01:41,10,999,503,556,2,2060
23:01:42,10,999,494,556,1,2050
23:01:43,10,999,498,556,2,2055
23:01:44,10,999,491,556,2,2048
23:01:45,10,999,492,556,2,2049
23:01:46,10,999,484,556,1,2040
23:01:47,10,999,504,556,2,2061
23:01:48,10,999,477,556,1,2033
23:01:49,10,999,491,556,4,2050
23:01:50,10,999,502,556,1,2058
23:01:51,10,999,488,556,1,2044
23:01:52,10,999,486,555,2,2042
23:01:53,10,999,485,555,1,2040
23:01:54,10,999,486,555,0,2040
23:01:55,10,999,493,555,0,2047
23:01:56,10,999,495,555,0,2049
23:01:57,10,0,0,0,0,0
23:01:58,10,999,496,554,1,2050
23:01:59,10,999,490,554,1,2044
23:02:00,10,999,495,554,1,2049
23:02:01,10,999,480,554,1,2034
23:02:02,10,999,488,553,0,2040
23:02:03,10,999,501,553,2,2055
23:02:04,10,999,486,553,1,2039
23:02:05,10,999,473,553,2,2027
23:02:06,10,999,495,553,1,2048
23:02:07,10,0,0,0,0,0
23:02:08,10,999,498,552,1,2050
23:02:09,10,999,492,552,1,2044
23:02:10,10,999,493,552,0,2044
23:02:11,10,999,493,551,1,2044
23:02:12,10,999,494,551,1,2045
23:02:13,10,999,501,551,2,2053
23:02:14,10,999,487,551,1,2038
23:02:15,10,999,497,550,1,2047
23:02:16,10,999,490,550,1,2040
23:02:17,10,999,495,550,1,2045
23:02:18,10,999,488,549,1,2037
23:02:19,10,0,0,0,0,0
23:02:20,10,999,503,549,2,2053
23:02:21,10,999,496,549,1,2045
23:02:22,10,999,485,549,1,2034
23:02:23,10,999,478,548,1,2026
23:02:24,10,0,0,0,0,0
23:02:25,10,999,497,548,0,2044
23:02:26,10,999,498,548,1,2046
23:02:27,10,999,491,547,1,2038
23:02:28,10,999,492,547,1,2039
23:02:29,10,999,497,547,1,2044
23:02:30,10,999,489,547,1,2036
23:02:31,10,999,494,546,1,2040
23:02:32,10,999,495,547,1,2042
23:02:33,10,0,0,0,0,0
23:02:34,10,999,494,546,0,2039
23:02:35,10,999,492,546,0,2037
23:02:36,10,1000,494,546,0,2040
23:02:37,10,1000,492,546,1,2039
23:02:38,10,1000,502,545,1,2048
23:02:39,10,1000,493,545,1,2039
23:02:40,10,999,490,545,1,2035
23:02:41,10,1000,490,545,0,2035
23:02:42,10,1000,495,545,1,2041
23:02:43,10,1000,494,545,1,2040
23:02:44,10,1000,491,544,1,2036
23:02:45,10,1000,498,545,0,2043
23:02:46,10,1000,494,544,2,2040
23:02:47,10,1000,489,544,1,2034
23:02:48,10,999,492,544,1,2036
23:02:49,10,999,491,544,0,2034
23:02:50,10,1000,492,544,1,2037
23:02:51,10,1000,494,544,1,2039
23:02:52,10,1000,494,544,2,2040
23:02:53,10,1000,488,543,1,2032
23:02:54,10,1000,497,544,0,2041
23:02:55,10,999,574,543,1,2117
23:02:56,10,1000,498,543,0,2041
23:02:57,10,1000,500,543,1,2044
23:02:58,10,1000,497,543,1,2041
23:02:59,10,999,482,543,1,2025
23:03:00,10,1000,499,543,1,2043
23:03:01,10,999,495,543,1,2038
23:03:02,10,0,0,0,0,0
23:03:03,10,1000,491,543,1,2035
23:03:04,10,1000,495,543,1,2039
23:03:05,10,1000,497,542,0,2039
23:03:06,10,1000,497,542,0,2039
23:03:07,10,1000,480,542,0,2022
23:03:08,10,1000,490,542,0,2032
23:03:09,10,1000,474,542,1,2017
23:03:10,10,1000,491,542,0,2033
23:03:11,10,1000,485,542,0,2027
23:03:12,10,1000,495,542,1,2038
23:03:13,10,1000,489,542,1,2032
23:03:14,10,0,0,0,0,0
23:03:15,10,1000,496,542,0,2038
23:03:16,10,1000,503,541,0,2044
23:03:17,10,1000,499,542,2,2043
23:03:18,10,1000,484,541,1,2026
23:03:19,10,1000,492,541,1,2034
23:03:20,10,1000,492,541,1,2034
23:03:21,10,1000,489,541,0,2030
23:03:22,10,1000,493,541,0,2034
23:03:23,10,1000,492,541,1,2034
23:03:24,10,1000,492,541,1,2034
23:03:25,10,1001,495,541,1,2038
23:03:26,10,1000,495,541,0,2036
23:03:27,10,1001,498,541,1,2041
23:03:28,10,1000,494,540,1,2035
23:03:29,10,1001,481,540,2,2024
23:03:30,10,1000,490,540,1,2031
23:03:31,10,1000,492,540,1,2033
23:03:32,10,1001,489,540,0,2030
23:03:33,10,1001,490,540,1,2032
23:03:34,10,1000,496,540,1,2037
23:03:35,10,1001,496,540,0,2037
23:03:36,10,1000,493,540,0,2033
23:03:37,10,1000,491,540,0,2031
23:03:38,10,1000,495,540,1,2036
23:03:39,10,1001,491,539,0,2031
23:03:40,10,1001,493,539,2,2035
23:03:41,10,1001,495,539,0,2035
23:03:42,10,1001,488,540,0,2029
23:03:43,10,1000,485,539,0,2024
23:03:44,10,1001,500,539,0,2040
23:03:45,10,1000,514,539,0,2053
23:03:46,10,1000,491,539,1,2031
23:03:47,10,1001,487,538,0,2026
23:03:48,10,0,0,0,0,0
23:03:49,10,1001,507,539,1,2048
23:03:50,10,1000,394,538,1,1933
23:03:51,10,1000,486,538,0,2024
23:03:52,10,1001,485,539,1,2026
23:03:53,10,1000,472,538,1,2011
23:03:54,10,1000,493,538,0,2031
23:03:55,10,1000,478,538,0,2016
23:03:56,10,1000,499,538,2,2039
23:03:57,10,999,494,538,1,2032
23:03:58,10,1000,493,538,1,2032
23:03:59,10,1001,491,538,0,2030
23:04:00,10,1001,499,538,2,2040
23:04:01,10,1001,487,538,0,2026
23:04:02,10,1001,506,538,0,2045
23:04:03,10,1002,497,538,1,2038
23:04:04,10,1002,498,538,1,2039
23:04:05,10,1001,497,538,0,2036
23:04:06,10,1001,490,538,1,2030
23:04:07,10,1002,486,538,1,2027
23:04:08,10,1002,493,538,0,2033
23:04:09,10,1001,497,538,1,2037
23:04:10,10,1002,491,537,0,2030
23:04:11,10,1001,497,537,1,2036
23:04:12,10,1002,490,537,1,2030
23:04:13,10,1001,494,537,1,2033
23:04:14,10,1002,499,537,0,2038
23:04:15,10,1002,490,537,0,2029
23:04:16,10,1002,479,537,1,2019
23:04:17,10,0,0,0,0,0
23:04:18,10,1001,500,537,1,2039
23:04:19,10,1001,490,537,1,2029
23:04:20,10,1002,488,537,1,2028
23:04:21,10,1001,489,537,1,2028
23:04:22,10,1001,484,537,1,2023
23:04:23,10,1002,496,537,1,2036
23:04:24,10,1002,493,537,0,2032
23:04:25,10,1001,496,536,1,2034
23:04:26,10,1001,490,536,0,2027
23:04:27,10,1001,495,536,1,2033
23:04:28,10,1002,492,536,1,2031
23:04:29,10,1001,490,536,0,2027
23:04:30,10,1000,493,536,0,2029
23:04:31,10,1001,488,536,2,2027
23:04:32,10,1001,486,536,1,2024
23:04:33,10,1001,493,536,0,2030
23:04:34,10,1001,496,536,1,2034
23:04:35,10,1000,492,536,0,2028
23:04:36,10,1000,497,536,1,2034
23:04:37,10,1000,476,537,1,2014
23:04:38,10,1000,494,536,1,2031
23:04:39,10,1000,493,536,0,2029
23:04:40,10,1001,493,536,0,2030
23:04:41,10,1000,495,536,1,2032
23:04:42,10,0,0,0,0,0
23:04:43,10,1000,498,536,0,2034
23:04:44,10,1000,485,536,1,2022
23:04:45,10,1000,495,536,0,2031
23:04:46,10,1000,488,536,0,2024
23:04:47,10,1000,493,536,0,2029
23:04:48,10,1000,494,536,0,2030
23:04:49,10,1000,497,536,1,2034
23:04:50,10,1001,504,536,0,2041
23:04:51,10,1000,496,536,1,2033
23:04:52,10,1001,493,536,1,2031
23:04:53,10,1001,495,536,2,2034
23:04:54,10,1000,495,536,1,2032
23:04:55,10,1000,493,536,1,2030
23:04:56,10,1000,490,536,1,2027
23:04:57,10,1001,492,536,1,2030
23:04:58,10,1000,495,536,1,2032
23:04:59,10,1001,481,536,1,2019
23:05:00,10,1001,486,536,1,2024
23:05:01,10,1000,489,536,1,2026
23:05:02,10,1001,492,536,1,2030
23:05:03,10,1001,493,536,1,2031
23:05:04,10,1001,497,536,1,2035
23:05:05,10,1001,492,536,1,2030
23:05:06,10,1001,492,536,0,2029
23:05:07,10,1001,495,536,1,2033
23:05:08,10,1001,491,536,0,2028
23:05:09,10,1001,497,536,1,2035
23:05:10,10,1001,496,536,1,2034
23:05:11,10,1002,492,536,0,2030
23:05:12,10,1001,499,536,1,2037
23:05:13,10,1001,489,536,0,2026
23:05:14,10,1001,493,536,0,2030
23:05:15,10,1001,497,536,1,2035
23:05:16,10,0,0,0,0,0
23:05:17,10,1002,486,536,1,2025
23:05:18,10,0,0,0,0,0
23:05:19,10,1002,496,536,0,2034
23:05:20,10,1003,492,536,1,2032
23:05:21,10,1003,493,536,1,2033
23:05:22,10,1003,493,536,1,2033
23:05:23,10,1003,490,536,1,2030
23:05:24,10,1004,489,536,0,2029
23:05:25,10,1004,494,536,1,2035
23:05:26,10,1004,498,536,0,2038
23:05:27,10,1004,488,536,1,2029
23:05:28,10,1004,493,537,1,2035
23:05:29,10,1004,492,537,1,2034
23:05:30,10,1004,491,536,1,2032
23:05:31,10,1004,496,536,1,2037
23:05:32,10,1004,498,536,1,2039
23:05:33,10,1005,492,536,0,2033
23:05:34,10,1005,508,536,1,2050
23:05:35,10,1004,497,536,1,2038
23:05:36,10,1005,489,536,2,2032
23:05:37,10,1006,487,536,1,2030
23:05:38,10,1005,494,536,0,2035
23:05:39,10,1005,495,536,1,2037
23:05:40,10,1005,493,536,1,2035
23:05:41,10,1005,498,536,1,2040
23:05:42,10,1005,495,536,0,2036
23:05:43,10,1006,500,536,1,2043
23:05:44,10,0,0,0,0,0
23:05:45,10,1006,488,536,1,2031
23:05:46,10,1005,491,536,0,2032
23:05:47,10,1006,492,536,1,2035
23:05:48,10,1006,493,536,0,2035
23:05:49,10,1006,496,536,2,2040
23:05:50,10,1006,494,536,1,2037
23:05:51,10,1006,491,536,1,2034
23:05:52,10,1007,485,536,0,2028
23:05:53,10,1006,486,536,1,2029
23:05:54,10,1006,493,536,0,2035
23:05:55,10,1007,498,536,1,2042
23:05:56,10,1006,491,537,1,2035
23:05:57,10,1006,502,537,1,2046
23:05:58,10,1007,488,537,0,2032
23:05:59,10,0,0,0,0,0
23:06:00,10,1005,491,537,1,2034
23:06:01,10,1006,492,537,0,2035
23:06:02,10,1006,489,537,1,2033
23:06:03,10,1006,492,537,0,2035
23:06:04,10,1006,485,537,1,2029
23:06:05,10,1005,498,537,0,2040
23:06:06,10,1006,484,537,1,2028
23:06:07,10,1006,496,538,1,2041
23:06:08,10,1006,492,538,0,2036
23:06:09,10,1006,498,538,2,2044
23:06:10,10,1006,491,538,1,2036
23:06:11,10,1007,493,538,0,2038
23:06:12,10,1006,495,538,1,2040
23:06:13,10,1007,502,538,1,2048
23:06:14,10,1006,491,538,1,2036
23:06:15,10,1006,496,538,0,2040
23:06:16,10,996,482,538,1,2017
23:06:17,10,1006,483,538,1,2028
23:06:18,10,1007,489,538,0,2034
23:06:19,10,1006,489,538,0,2033
23:06:20,10,1006,495,538,0,2039
23:06:21,10,1006,493,538,0,2037
23:06:22,10,1007,484,538,0,2029
23:06:23,10,1006,487,538,0,2031
23:06:24,10,1007,477,538,0,2022
23:06:25,10,1006,488,538,1,2033
23:06:26,10,1007,487,538,1,2033
23:06:27,10,1006,498,538,0,2042
23:06:28,10,0,0,0,0,0
23:06:29,10,0,0,0,0,0
23:06:30,10,1007,483,538,1,2029
23:06:31,10,1006,491,538,1,2036
23:06:32,10,1007,492,538,1,2038
23:06:33,10,1007,492,538,0,2037
23:06:34,10,1007,496,538,1,2042
23:06:35,10,1007,483,538,1,2029
23:06:36,10,1007,527,538,0,2072
23:06:37,10,1006,488,538,1,2033
23:06:38,10,1007,491,538,0,2036
23:06:39,10,1007,483,538,0,2028
23:06:40,10,1006,491,538,1,2036
23:06:41,10,1006,493,538,1,2038
23:06:42,10,1007,453,538,1,1999
23:06:43,10,1007,494,538,1,2040
23:06:44,10,1006,492,538,0,2036
23:06:45,10,1007,496,538,0,2041
23:06:46,10,1006,493,538,1,2038
23:06:47,10,1006,494,538,0,2038
23:06:48,10,1006,491,538,0,2035
23:06:49,10,1007,481,538,0,2026
23:06:50,10,1007,481,538,1,2027
23:06:51,10,1006,492,538,1,2037
23:06:52,10,1006,495,538,2,2041
23:06:53,10,1006,504,538,1,2049
23:06:54,10,0,0,0,0,0
23:06:55,10,1006,493,538,2,2039
23:06:56,10,1006,495,538,0,2039
23:06:57,10,1006,483,538,0,2027
23:06:58,10,1006,490,538,0,2034
23:06:59,10,1006,481,538,1,2026
23:07:00,10,1006,509,538,1,2054
23:07:01,10,1006,483,538,1,2028
23:07:02,10,1006,494,537,0,2037
23:07:03,10,1006,494,537,0,2037
23:07:04,10,1006,479,537,1,2023
23:07:05,10,999,597,530,0,2126
22:50:41,11,0,0,0,0,0
22:50:42,11,0,0,0,0,0
22:50:43,11,0,0,0,0,0
22:50:44,11,0,0,0,0,0
22:50:45,11,0,0,0,0,0
22:50:46,11,0,0,0,0,0
22:50:47,11,0,0,0,0,0
22:50:48,11,0,0,0,0,0
22:50:49,11,1001,486,536,0,2023
22:50:50,11,1001,472,536,0,2009
22:50:51,11,0,0,0,0,0
22:50:52,11,0,0,0,0,0
22:50:53,11,0,0,0,0,0
22:50:54,11,0,0,0,0,0
22:50:55,11,0,0,0,0,0
22:50:56,11,1001,507,536,0,2044
22:50:57,11,0,0,0,0,0
22:50:58,11,0,0,0,0,0
22:50:59,11,0,0,0,0,0
22:51:00,11,0,0,0,0,0
22:51:01,11,0,0,0,0,0
22:51:02,11,0,0,0,0,0
22:51:03,11,0,0,0,0,0
22:51:04,11,0,0,0,0,0
22:51:05,11,0,0,0,0,0
22:51:06,11,0,0,0,0,0
22:51:07,11,0,0,0,0,0
22:51:08,11,0,0,0,0,0
22:51:09,11,0,0,0,0,0
22:51:10,11,0,0,0,0,0
22:51:11,11,0,0,0,0,0
22:51:12,11,0,0,0,0,0
22:51:13,11,0,0,0,0,0
22:51:14,11,1002,496,537,0,2035
22:51:15,11,0,0,0,0,0
22:51:16,11,0,0,0,0,0
22:51:17,11,1001,490,537,0,2028
22:51:18,11,0,0,0,0,0
22:51:19,11,0,0,0,0,0
22:51:20,11,1001,493,536,0,2030
22:51:21,11,0,0,0,0,0
22:51:22,11,0,0,0,0,0
22:51:23,11,1001,475,537,0,2013
22:51:24,11,0,0,0,0,0
22:51:25,11,0,0,0,0,0
22:51:26,11,0,0,0,0,0
22:51:27,11,0,0,0,0,0
22:51:28,11,0,0,0,0,0
22:51:29,11,0,0,0,0,0
22:51:30,11,0,0,0,0,0
22:51:31,11,0,0,0,0,0
22:51:32,11,0,0,0,0,0
22:51:33,11,0,0,0,0,0
22:51:34,11,0,0,0,0,0
22:51:35,11,0,0,0,0,0
22:51:36,11,0,0,0,0,0
22:51:37,11,1001,498,536,0,2035
22:51:38,11,1000,490,536,225,2251
22:51:39,11,0,0,0,0,0
22:51:40,11,0,0,0,0,0
22:51:41,11,0,0,0,0,0
22:51:42,11,0,0,0,0,0
22:51:43,11,0,0,0,0,0
22:51:44,11,0,0,0,0,0
22:51:45,11,0,0,0,0,0
22:51:46,11,0,0,0,0,0
22:51:47,11,0,0,0,0,0
22:51:48,11,0,0,0,0,0
22:51:49,11,0,0,0,0,0
22:51:50,11,0,0,0,0,0
22:51:51,11,1000,492,536,569,2597
22:51:52,11,0,0,0,0,0
22:51:53,11,1001,497,536,466,2500
22:51:54,11,1001,485,536,267,2289
22:51:55,11,0,0,0,0,0
22:51:56,11,0,0,0,0,0
22:51:57,11,0,0,0,0,0
22:51:58,11,0,0,0,0,0
22:51:59,11,0,0,0,0,0
22:52:00,11,0,0,0,0,0
22:52:01,11,0,0,0,0,0
22:52:02,11,0,0,0,0,0
22:52:03,11,0,0,0,0,0
22:52:04,11,1003,500,571,339,2413
22:52:05,11,0,0,0,0,0
22:52:06,11,0,0,0,0,0
22:52:07,11,0,0,0,0,0
22:52:08,11,1001,489,583,479,2552
22:52:09,11,1002,470,586,510,2568
22:52:10,11,1001,505,589,474,2569
22:52:11,11,1002,480,595,506,2583
22:52:12,11,1002,522,598,653,2775
22:52:13,11,1002,510,601,360,2473
22:52:14,11,1002,485,604,420,2511
22:52:15,11,1002,489,609,631,2731
22:52:16,11,1001,510,612,594,2717
22:52:17,11,0,0,0,0,0
22:52:18,11,1002,538,615,459,2614
22:52:19,11,0,0,0,0,0
22:52:20,11,0,0,0,0,0
22:52:21,11,1001,491,628,560,2680
22:52:22,11,1000,532,629,575,2736
22:52:23,11,1002,510,633,319,2464
22:52:24,11,0,0,0,0,0
22:52:25,11,0,0,0,0,0
22:52:26,11,0,0,0,0,0
22:52:27,11,0,0,0,0,0
22:52:28,11,0,0,0,0,0
22:52:29,11,0,0,0,0,0
22:52:30,11,1001,517,643,460,2621
22:52:31,11,1000,465,648,263,2376
22:52:32,11,0,0,0,0,0
22:52:33,11,0,0,0,0,0
22:52:34,11,1001,476,654,828,2959
22:52:35,11,1000,369,655,985,3009
22:52:36,11,0,0,0,0,0
22:52:37,11,1001,488,657,931,3077
22:52:38,11,0,0,0,0,0
22:52:39,11,1001,496,662,942,3101
22:52:40,11,1000,489,662,921,3072
22:52:41,11,1000,498,663,959,3120
22:52:42,11,1000,498,664,800,2962
22:52:43,11,1001,478,666,876,3021
22:52:44,11,1000,499,667,798,2964
22:52:45,11,1001,512,668,818,2999
22:52:46,11,1000,501,668,812,2981
22:52:47,11,999,491,669,866,3025
22:52:48,11,999,500,670,903,3072
22:52:49,11,999,506,670,862,3037
22:52:50,11,1002,502,671,890,3065
22:52:51,11,0,0,0,0,0
22:52:52,11,0,0,0,0,0
22:52:53,11,0,0,0,0,0
22:52:54,11,0,0,0,0,0
22:52:55,11,0,0,0,0,0
22:52:56,11,0,0,0,0,0
22:52:57,11,0,0,0,0,0
22:52:58,11,0,0,0,0,0
22:52:59,11,1002,499,677,834,3012
22:53:00,11,0,0,0,0,0
22:53:01,11,1000,485,676,884,3045
22:53:02,11,0,0,0,0,0
22:53:03,11,0,0,0,0,0
22:53:04,11,0,0,0,0,0
22:53:05,11,1000,491,675,809,2975
22:53:06,11,0,0,0,0,0
22:53:07,11,0,0,0,0,0
22:53:08,11,0,0,0,0,0
22:53:09,11,0,0,0,0,0
22:53:10,11,1001,493,679,831,3004
22:53:11,11,0,0,0,0,0
22:53:12,11,0,0,0,0,0
22:53:13,11,0,0,0,0,0
22:53:14,11,0,0,0,0,0
22:53:15,11,0,0,0,0,0
22:53:16,11,1002,479,688,884,3053
22:53:17,11,1002,489,691,907,3089
22:53:18,11,1002,491,692,759,2944
22:53:19,11,0,0,0,0,0
22:53:20,11,0,0,0,0,0
22:53:21,11,1001,502,701,915,3119
22:53:22,11,1001,507,703,785,2996
22:53:23,11,0,0,0,0,0
22:53:24,11,0,0,0,0,0
22:53:25,11,1000,499,711,845,3055
22:53:26,11,0,0,0,0,0
22:53:27,11,0,0,0,0,0
22:53:28,11,0,0,0,0,0
22:53:29,11,0,0,0,0,0
22:53:30,11,0,0,0,0,0
22:53:31,11,0,0,0,0,0
22:53:32,11,0,0,0,0,0
22:53:33,11,0,0,0,0,0
22:53:34,11,1001,504,725,935,3165
22:53:35,11,0,0,0,0,0
22:53:36,11,1000,483,723,839,3045
22:53:37,11,0,0,0,0,0
22:53:38,11,1000,507,726,967,3200
22:53:39,11,0,0,0,0,0
22:53:40,11,0,0,0,0,0
22:53:41,11,0,0,0,0,0
22:53:42,11,0,0,0,0,0
22:53:43,11,0,0,0,0,0
22:53:44,11,0,0,0,0,0
22:53:45,11,0,0,0,0,0
22:53:46,11,0,0,0,0,0
22:53:47,11,0,0,0,0,0
22:53:48,11,999,493,745,857,3094
22:53:49,11,1000,501,748,964,3213
22:53:50,11,0,0,0,0,0
22:53:51,11,0,0,0,0,0
22:53:52,11,0,0,0,0,0
22:53:53,11,0,0,0,0,0
22:53:54,11,0,0,0,0,0
22:53:55,11,1000,496,750,755,3001
22:53:56,11,0,0,0,0,0
22:53:57,11,0,0,0,0,0
22:53:58,11,0,0,0,0,0
22:53:59,11,1000,488,744,978,3210
22:54:00,11,0,0,0,0,0
22:54:01,11,0,0,0,0,0
22:54:02,11,0,0,0,0,0
22:54:03,11,0,0,0,0,0
22:54:04,11,0,0,0,0,0
22:54:05,11,0,0,0,0,0
22:54:06,11,0,0,0,0,0
22:54:07,11,0,0,0,0,0
22:54:08,11,0,0,0,0,0
22:54:09,11,0,0,0,0,0
22:54:10,11,999,509,741,820,3069
22:54:11,11,0,0,0,0,0
22:54:12,11,999,506,740,911,3156
22:54:13,11,0,0,0,0,0
22:54:14,11,0,0,0,0,0
22:54:15,11,0,0,0,0,0
22:54:16,11,0,0,0,0,0
22:54:17,11,1000,486,747,977,3210
22:54:18,11,0,0,0,0,0
22:54:19,11,0,0,0,0,0
22:54:20,11,1000,509,750,858,3117
22:54:21,11,999,488,751,982,3220
22:54:22,11,999,480,751,903,3133
22:54:23,11,999,520,751,789,3059
22:54:24,11,0,0,0,0,0
22:54:25,11,0,0,0,0,0
22:54:26,11,0,0,0,0,0
22:54:27,11,0,0,0,0,0
22:54:28,11,0,0,0,0,0
22:54:29,11,0,0,0,0,0
22:54:30,11,0,0,0,0,0
22:54:31,11,0,0,0,0,0
22:54:32,11,0,0,0,0,0
22:54:33,11,0,0,0,0,0
22:54:34,11,0,0,0,0,0
22:54:35,11,0,0,0,0,0
22:54:36,11,999,496,760,990,3245
22:54:37,11,0,0,0,0,0
22:54:38,11,999,476,761,862,3098
22:54:39,11,0,0,0,0,0
22:54:40,11,0,0,0,0,0
22:54:41,11,999,500,761,832,3092
22:54:42,11,1000,507,761,973,3241
22:54:43,11,0,0,0,0,0
22:54:44,11,999,498,762,963,3222
22:54:45,11,0,0,0,0,0
22:54:46,11,0,0,0,0,0
22:54:47,11,999,483,764,843,3089
22:54:48,11,0,0,0,0,0
22:54:49,11,0,0,0,0,0
22:54:50,11,0,0,0,0,0
22:54:51,11,0,0,0,0,0
22:54:52,11,997,505,762,979,3243
22:54:53,11,998,495,762,900,3155
22:54:54,11,0,0,0,0,0
22:54:55,11,998,497,762,889,3146
22:54:56,11,0,0,0,0,0
22:54:57,11,999,509,762,969,3239
22:54:58,11,0,0,0,0,0
22:54:59,11,1000,502,764,786,3052
22:55:00,11,0,0,0,0,0
22:55:01,11,0,0,0,0,0
22:55:02,11,0,0,0,0,0
22:55:03,11,0,0,0,0,0
22:55:04,11,1000,502,761,990,3253
22:55:05,11,0,0,0,0,0
22:55:06,11,0,0,0,0,0
22:55:07,11,0,0,0,0,0
22:55:08,11,0,0,0,0,0
22:55:09,11,1000,497,756,851,3104
22:55:10,11,999,494,757,893,3143
22:55:11,11,0,0,0,0,0
22:55:12,11,999,498,755,924,3176
22:55:13,11,999,519,753,837,3108
22:55:14,11,999,497,752,936,3184
22:55:15,11,999,496,752,920,3167
22:55:16,11,0,0,0,0,0
22:55:17,11,0,0,0,0,0
22:55:18,11,0,0,0,0,0
22:55:19,11,999,484,746,852,3081
22:55:20,11,999,488,743,868,3098
22:55:21,11,0,0,0,0,0
22:55:22,11,1001,485,744,779,3009
22:55:23,11,999,519,743,973,3234
22:55:24,11,0,0,0,0,0
22:55:25,11,1000,501,743,833,3077
22:55:26,11,1000,497,743,946,3186
22:55:27,11,1000,495,742,813,3050
22:55:28,11,999,494,742,858,3093
22:55:29,11,1000,492,742,893,3127
22:55:30,11,0,0,0,0,0
22:55:31,11,0,0,0,0,0
22:55:32,11,0,0,0,0,0
22:55:33,11,0,0,0,0,0
22:55:34,11,0,0,0,0,0
22:55:35,11,0,0,0,0,0
22:55:36,11,0,0,0,0,0
22:55:37,11,999,489,734,845,3067
22:55:38,11,999,499,735,871,3104
22:55:39,11,999,494,734,879,3106
22:55:40,11,999,489,735,890,3113
22:55:41,11,999,497,734,886,3116
22:55:42,11,1000,493,733,883,3109
22:55:43,11,999,495,733,923,3150
22:55:44,11,999,489,733,884,3105
22:55:45,11,1000,492,733,863,3088
22:55:46,11,999,485,732,902,3118
22:55:47,11,999,488,732,854,3073
22:55:48,11,999,492,730,816,3037
22:55:49,11,0,0,0,0,0
22:55:50,11,1000,481,729,784,2994
22:55:51,11,999,491,726,860,3076
22:55:52,11,1000,490,724,882,3096
22:55:53,11,1000,489,723,906,3118
22:55:54,11,1000,495,722,858,3075
22:55:55,11,1000,493,721,975,3189
22:55:56,11,1000,495,720,855,3070
22:55:57,11,1000,497,717,868,3082
22:55:58,11,999,492,716,852,3059
22:55:59,11,1000,492,715,892,3099
22:56:00,11,0,0,0,0,0
22:56:01,11,1001,502,714,925,3142
22:56:02,11,1000,487,712,871,3070
22:56:03,11,1000,497,712,831,3040
22:56:04,11,1000,498,711,886,3095
22:56:05,11,1000,496,711,981,3188
22:56:06,11,1000,492,711,856,3059
22:56:07,11,1000,500,711,894,3105
22:56:08,11,999,496,710,854,3059
22:56:09,11,0,0,0,0,0
22:56:10,11,1000,493,707,836,3036
22:56:11,11,1000,497,706,845,3048
22:56:12,11,1000,496,705,868,3069
22:56:13,11,999,495,704,875,3073
22:56:14,11,1000,495,703,886,3084
22:56:15,11,1000,488,702,908,3098
22:56:16,11,0,0,0,0,0
22:56:17,11,0,0,0,0,0
22:56:18,11,1000,506,700,553,2759
22:56:19,11,999,502,700,524,2725
22:56:20,11,999,499,700,417,2615
22:56:21,11,999,505,701,610,2815
22:56:22,11,1000,495,701,542,2738
22:56:23,11,999,489,701,529,2718
22:56:24,11,999,493,703,441,2636
22:56:25,11,0,0,0,0,0
22:56:26,11,999,478,704,534,2715
22:56:27,11,999,495,704,763,2961
22:56:28,11,0,0,0,0,0
22:56:29,11,0,0,0,0,0
22:56:30,11,0,0,0,0,0
22:56:31,11,0,0,0,0,0
22:56:32,11,0,0,0,0,0
22:56:33,11,0,0,0,0,0
22:56:34,11,999,487,702,791,2979
22:56:35,11,0,0,0,0,0
22:56:36,11,0,0,0,0,0
22:56:37,11,0,0,0,0,0
22:56:38,11,0,0,0,0,0
22:56:39,11,0,0,0,0,0
22:56:40,11,0,0,0,0,0
22:56:41,11,0,0,0,0,0
22:56:42,11,0,0,0,0,0
22:56:43,11,0,0,0,0,0
22:56:44,11,0,0,0,0,0
22:56:45,11,0,0,0,0,0
22:56:46,11,999,492,710,420,2621
22:56:47,11,0,0,0,0,0
22:56:48,11,999,495,711,381,2586
22:56:49,11,999,510,712,539,2760
22:56:50,11,999,493,713,343,2548
22:56:51,11,0,0,0,0,0
22:56:52,11,0,0,0,0,0
22:56:53,11,0,0,0,0,0
22:56:54,11,0,0,0,0,0
22:56:55,11,0,0,0,0,0
22:56:56,11,0,0,0,0,0
22:56:57,11,0,0,0,0,0
22:56:58,11,999,495,712,762,2968
22:56:59,11,999,491,712,868,3070
22:57:00,11,0,0,0,0,0
22:57:01,11,999,540,711,981,3231
22:57:02,11,998,498,712,818,3026
22:57:03,11,999,496,711,915,3121
22:57:04,11,999,491,712,895,3097
22:57:05,11,999,492,710,945,3146
22:57:06,11,999,486,710,922,3117
22:57:07,11,999,495,711,849,3054
22:57:08,11,0,0,0,0,0
22:57:09,11,0,0,0,0,0
22:57:10,11,999,509,709,941,3158
22:57:11,11,999,484,710,909,3102
22:57:12,11,999,490,712,998,3199
22:57:13,11,0,0,0,0,0
22:57:14,11,998,500,712,878,3088
22:57:15,11,0,0,0,0,0
22:57:16,11,0,0,0,0,0
22:57:17,11,0,0,0,0,0
22:57:18,11,0,0,0,0,0
22:57:19,11,999,494,702,863,3058
22:57:20,11,999,494,703,492,2688
22:57:21,11,999,489,703,523,2714
22:57:22,11,999,498,704,499,2700
22:57:23,11,999,494,706,434,2633
22:57:24,11,998,494,706,444,2642
22:57:25,11,998,495,706,472,2671
22:57:26,11,999,491,706,323,2519
22:57:27,11,999,503,705,497,2704
22:57:28,11,999,498,705,445,2647
22:57:29,11,999,504,704,370,2577
22:57:30,11,999,494,703,506,2702
22:57:31,11,999,517,698,474,2688
22:57:32,11,999,473,696,412,2580
22:57:33,11,1000,492,694,507,2693
22:57:34,11,1000,510,693,566,2769
22:57:35,11,0,0,0,0,0
22:57:36,11,0,0,0,0,0
22:57:37,11,0,0,0,0,0
22:57:38,11,1000,496,689,381,2566
22:57:39,11,0,0,0,0,0
22:57:40,11,0,0,0,0,0
22:57:41,11,0,0,0,0,0
22:57:42,11,999,494,689,632,2814
22:57:43,11,999,489,690,732,2910
22:57:44,11,0,0,0,0,0
22:57:45,11,0,0,0,0,0
22:57:46,11,0,0,0,0,0
22:57:47,11,0,0,0,0,0
22:57:48,11,999,498,690,520,2707
22:57:49,11,0,0,0,0,0
22:57:50,11,0,0,0,0,0
22:57:51,11,0,0,0,0,0
22:57:52,11,0,0,0,0,0
22:57:53,11,0,0,0,0,0
22:57:54,11,0,0,0,0,0
22:57:55,11,0,0,0,0,0
22:57:56,11,0,0,0,0,0
22:57:57,11,999,492,685,579,2755
22:57:58,11,0,0,0,0,0
22:57:59,11,999,500,683,482,2664
22:58:00,11,999,489,682,422,2592
22:58:01,11,0,0,0,0,0
22:58:02,11,999,489,677,849,3014
22:58:03,11,1000,490,675,847,3012
22:58:04,11,0,0,0,0,0
22:58:05,11,0,0,0,0,0
22:58:06,11,0,0,0,0,0
22:58:07,11,0,0,0,0,0
22:58:08,11,0,0,0,0,0
22:58:09,11,999,497,663,946,3105
22:58:10,11,0,0,0,0,0
22:58:11,11,0,0,0,0,0
22:58:12,11,0,0,0,0,0
22:58:13,11,0,0,0,0,0
22:58:14,11,1000,502,664,826,2992
22:58:15,11,0,0,0,0,0
22:58:16,11,999,496,668,878,3041
22:58:17,11,0,0,0,0,0
22:58:18,11,999,495,670,882,3046
22:58:19,11,0,0,0,0,0
22:58:20,11,0,0,0,0,0
22:58:21,11,0,0,0,0,0
22:58:22,11,999,496,673,832,3000
22:58:23,11,0,0,0,0,0
22:58:24,11,999,507,675,905,3086
22:58:25,11,998,501,676,924,3099
22:58:26,11,998,490,676,846,3010
22:58:27,11,999,496,676,933,3104
22:58:28,11,0,0,0,0,0
22:58:29,11,998,495,677,996,3166
22:58:30,11,0,0,0,0,0
22:58:31,11,998,500,678,921,3097
22:58:32,11,0,0,0,0,0
22:58:33,11,997,495,679,943,3114
22:58:34,11,997,495,679,808,2979
22:58:35,11,998,493,678,259,2428
22:58:36,11,998,502,677,437,2614
22:58:37,11,0,0,0,0,0
22:58:38,11,0,0,0,0,0
22:58:39,11,0,0,0,0,0
22:58:40,11,0,0,0,0,0
22:58:41,11,0,0,0,0,0
22:58:42,11,0,0,0,0,0
22:58:43,11,0,0,0,0,0
22:58:44,11,0,0,0,0,0
22:58:45,11,0,0,0,0,0
22:58:46,11,999,492,666,716,2873
22:58:47,11,0,0,0,0,0
22:58:48,11,0,0,0,0,0
22:58:49,11,0,0,0,0,0
22:58:50,11,0,0,0,0,0
22:58:51,11,999,500,667,397,2563
22:58:52,11,0,0,0,0,0
22:58:53,11,998,491,668,887,3044
22:58:54,11,999,500,668,944,3111
22:58:55,11,999,507,670,941,3117
22:58:56,11,999,487,672,897,3055
22:58:57,11,999,494,674,812,2979
22:58:58,11,999,506,675,903,3083
22:58:59,11,999,505,679,898,3081
22:59:00,11,1000,500,681,909,3090
22:59:01,11,998,488,682,924,3092
22:59:02,11,999,495,683,891,3068
22:59:03,11,998,494,686,914,3092
22:59:04,11,998,503,686,900,3087
22:59:05,11,998,494,687,867,3046
22:59:06,11,998,495,688,946,3127
22:59:07,11,999,499,688,898,3084
22:59:08,11,998,495,688,845,3026
22:59:09,11,998,500,688,895,3081
22:59:10,11,998,503,687,903,3091
22:59:11,11,999,496,687,890,3072
22:59:12,11,999,488,686,874,3047
22:59:13,11,998,497,685,950,3130
22:59:14,11,998,498,684,902,3082
22:59:15,11,999,494,683,903,3079
22:59:16,11,999,488,682,864,3033
22:59:17,11,999,490,682,851,3022
22:59:18,11,999,494,681,870,3044
22:59:19,11,998,496,680,919,3093
22:59:20,11,999,493,679,902,3073
22:59:21,11,999,492,679,943,3113
22:59:22,11,999,496,677,953,3125
22:59:23,11,999,500,678,956,3133
22:59:24,11,1000,487,678,935,3100
22:59:25,11,998,499,678,907,3082
22:59:26,11,998,495,678,891,3062
22:59:27,11,999,494,679,886,3058
22:59:28,11,999,498,679,871,3047
22:59:29,11,999,498,679,897,3073
22:59:30,11,999,491,679,916,3085
22:59:31,11,999,496,678,902,3075
22:59:32,11,999,475,678,908,3060
22:59:33,11,999,498,678,919,3094
22:59:34,11,999,495,673,852,3019
22:59:35,11,1000,493,671,908,3072
22:59:36,11,999,495,670,940,3104
22:59:37,11,1000,518,669,819,3006
22:59:38,11,999,489,666,898,3052
22:59:39,11,999,493,664,853,3009
22:59:40,11,999,503,664,951,3117
22:59:41,11,999,494,662,922,3077
22:59:42,11,0,0,0,0,0
22:59:43,11,999,494,659,893,3045
22:59:44,11,1000,495,659,885,3039
22:59:45,11,999,494,658,896,3047
22:59:46,11,999,495,657,893,3044
22:59:47,11,999,501,655,916,3071
22:59:48,11,999,489,656,872,3016
22:59:49,11,999,500,656,815,2970
22:59:50,11,999,492,656,859,3006
22:59:51,11,1000,498,656,967,3121
22:59:52,11,1000,496,655,810,2961
22:59:53,11,1000,493,655,832,2980
22:59:54,11,0,0,0,0,0
22:59:55,11,0,0,0,0,0
22:59:56,11,1000,499,654,882,3035
22:59:57,11,1000,503,653,907,3063
22:59:58,11,0,0,0,0,0
22:59:59,11,999,502,653,904,3058
23:00:00,11,999,499,653,885,3036
23:00:01,11,999,494,654,942,3089
23:00:02,11,999,499,654,877,3029
23:00:03,11,999,497,654,961,3111
23:00:04,11,999,492,654,801,2946
23:00:05,11,999,490,655,919,3063
23:00:06,11,999,497,655,836,2987
23:00:07,11,0,0,0,0,0
23:00:08,11,0,0,0,0,0
23:00:09,11,999,505,654,988,3146
23:00:10,11,0,0,0,0,0
23:00:11,11,999,506,654,857,3016
23:00:12,11,0,0,0,0,0
23:00:13,11,0,0,0,0,0
23:00:14,11,999,492,654,873,3018
23:00:15,11,999,497,654,881,3031
23:00:16,11,999,500,654,862,3015
23:00:17,11,1000,491,654,954,3099
23:00:18,11,999,500,654,823,2976
23:00:19,11,999,506,653,909,3067
23:00:20,11,999,455,652,905,3011
23:00:21,11,999,535,651,880,3065
23:00:22,11,1000,483,652,880,3015
23:00:23,11,999,495,652,927,3073
23:00:24,11,1000,496,652,922,3070
23:00:25,11,0,0,0,0,0
23:00:26,11,0,0,0,0,0
23:00:27,11,0,0,0,0,0
23:00:28,11,999,473,651,953,3076
23:00:29,11,999,503,651,972,3125
23:00:30,11,999,511,652,923,3085
23:00:31,11,0,0,0,0,0
23:00:32,11,999,499,652,885,3035
23:00:33,11,999,495,653,850,2997
23:00:34,11,0,0,0,0,0
23:00:35,11,999,491,653,868,3011
23:00:36,11,999,498,652,911,3060
23:00:37,11,1000,509,652,907,3068
23:00:38,11,999,500,652,925,3076
23:00:39,11,999,499,652,939,3089
23:00:40,11,999,494,653,968,3114
23:00:41,11,999,500,653,954,3106
23:00:42,11,999,500,652,935,3086
23:00:43,11,999,493,654,951,3097
23:00:44,11,998,495,654,949,3096
23:00:45,11,999,496,655,940,3090
23:00:46,11,999,491,654,963,3107
23:00:47,11,998,495,654,945,3092
23:00:48,11,998,495,653,937,3083
23:00:49,11,999,493,652,961,3105
23:00:50,11,999,498,652,937,3086
23:00:51,11,999,497,651,932,3079
23:00:52,11,999,491,652,950,3092
23:00:53,11,999,493,651,933,3076
23:00:54,11,999,495,651,944,3089
23:00:55,11,999,500,649,935,3083
23:00:56,11,1000,502,650,998,3150
23:00:57,11,999,490,650,950,3089
23:00:58,11,999,470,650,74,2193
23:00:59,11,999,493,650,154,2296
23:01:00,11,999,500,650,136,2285
23:01:01,11,999,491,651,90,2231
23:01:02,11,999,488,649,181,2317
23:01:03,11,998,509,647,128,2282
23:01:04,11,998,510,646,95,2249
23:01:05,11,998,491,646,155,2290
23:01:06,11,998,489,645,93,2225
23:01:07,11,998,499,643,141,2281
23:01:08,11,998,493,643,138,2272
23:01:09,11,998,490,643,131,2262
23:01:10,11,998,512,643,122,2275
23:01:11,11,998,502,642,145,2287
23:01:12,11,998,507,642,125,2272
23:01:13,11,998,491,642,123,2254
23:01:14,11,998,502,640,161,2301
23:01:15,11,998,506,639,142,2285
23:01:16,11,998,506,639,136,2279
23:01:17,11,998,495,637,126,2256
23:01:18,11,998,489,638,139,2264
23:01:19,11,998,493,638,1,2130
23:01:20,11,998,497,638,2,2135
23:01:21,11,998,483,638,2,2121
23:01:22,11,998,487,637,2,2124
23:01:23,11,998,492,636,3,2129
23:01:24,11,998,502,636,2,2138
23:01:25,11,998,501,635,2,2136
23:01:26,11,998,486,635,2,2121
23:01:27,11,999,486,634,2,2121
23:01:28,11,998,488,633,1,2120
23:01:29,11,998,485,633,2,2118
23:01:30,11,998,507,632,2,2139
23:01:31,11,998,486,632,3,2119
23:01:32,11,998,509,631,2,2140
23:01:33,11,998,508,629,2,2137
23:01:34,11,999,517,623,2,2141
23:01:35,11,998,485,620,3,2106
23:01:36,11,998,466,618,3,2085
23:01:37,11,999,495,617,2,2113
23:01:38,11,998,503,615,2,2118
23:01:39,11,998,484,615,2,2099
23:01:40,11,999,538,614,2,2153
23:01:41,11,999,480,614,2,2095
23:01:42,11,998,501,614,2,2115
23:01:43,11,999,476,614,1,2090
23:01:44,11,998,485,612,2,2097
23:01:45,11,999,507,611,2,2119
23:01:46,11,999,497,611,2,2109
23:01:47,11,998,459,611,2,2070
23:01:48,11,999,476,610,2,2087
23:01:49,11,998,487,608,3,2096
23:01:50,11,999,473,608,2,2082
23:01:51,11,998,482,608,1,2089
23:01:52,11,998,514,608,1,2121
23:01:53,11,999,444,608,0,2051
23:01:54,11,998,461,607,1,2067
23:01:55,11,999,480,607,2,2088
23:01:56,11,999,526,606,1,2132
23:01:57,11,998,496,606,0,2100
23:01:58,11,999,513,606,2,2120
23:01:59,11,999,494,605,0,2098
23:02:00,11,998,500,605,1,2104
23:02:01,11,998,481,604,0,2083
23:02:02,11,998,504,605,0,2107
23:02:03,11,998,497,604,1,2100
23:02:04,11,999,492,604,1,2096
23:02:05,11,0,0,0,0,0
23:02:06,11,999,468,603,1,2071
23:02:07,11,998,521,602,0,2121
23:02:08,11,998,545,602,1,2146
23:02:09,11,999,478,601,0,2078
23:02:10,11,999,506,601,1,2107
23:02:11,11,998,503,601,0,2102
23:02:12,11,998,498,599,0,2095
23:02:13,11,998,474,598,0,2070
23:02:14,11,998,494,596,0,2088
23:02:15,11,0,0,0,0,0
23:02:16,11,999,519,594,1,2113
23:02:17,11,1000,500,592,1,2093
23:02:18,11,1000,472,591,1,2064
23:02:19,11,1000,498,591,1,2090
23:02:20,11,1000,489,590,1,2080
23:02:21,11,1000,512,590,1,2103
23:02:22,11,1000,496,587,1,2084
23:02:23,11,999,503,587,0,2089
23:02:24,11,999,493,586,1,2079
23:02:25,11,999,499,585,0,2083
23:02:26,11,1000,483,585,0,2068
23:02:27,11,999,486,584,1,2070
23:02:28,11,1000,489,583,1,2073
23:02:29,11,999,491,582,1,2073
23:02:30,11,1000,492,582,0,2074
23:02:31,11,1000,497,582,0,2079
23:02:32,11,999,489,581,1,2070
23:02:33,11,1000,509,580,1,2090
23:02:34,11,0,0,0,0,0
23:02:35,11,1000,490,580,0,2070
23:02:36,11,1000,495,580,1,2076
23:02:37,11,1000,493,579,1,2073
23:02:38,11,1000,497,579,0,2076
23:02:39,11,0,0,0,0,0
23:02:40,11,1000,493,577,1,2071
23:02:41,11,1000,499,576,0,2075
23:02:42,11,1000,499,576,1,2076
23:02:43,11,1000,503,576,1,2080
23:02:44,11,1000,490,575,1,2066
23:02:45,11,1000,495,575,0,2070
23:02:46,11,0,0,0,0,0
23:02:47,11,1000,493,574,1,2068
23:02:48,11,1000,491,574,1,2066
23:02:49,11,0,0,0,0,0
23:02:50,11,1000,495,574,1,2070
23:02:51,11,999,494,574,1,2068
23:02:52,11,1000,494,574,0,2068
23:02:53,11,1000,490,574,0,2064
23:02:54,11,1000,498,574,1,2073
23:02:55,11,1000,499,574,0,2073
23:02:56,11,1000,492,574,1,2067
23:02:57,11,1000,506,574,0,2080
23:02:58,11,1000,498,574,1,2073
23:02:59,11,1000,495,574,1,2070
23:03:00,11,1000,502,574,1,2077
23:03:01,11,1000,498,574,1,2073
23:03:02,11,1000,495,573,1,2069
23:03:03,11,1000,495,572,1,2068
23:03:04,11,1000,496,572,2,2070
23:03:05,11,1000,484,570,1,2055
23:03:06,11,1000,489,569,0,2058
23:03:07,11,1000,501,568,1,2070
23:03:08,11,1000,490,567,2,2059
23:03:09,11,1000,494,566,1,2061
23:03:10,11,1000,487,565,1,2053
23:03:11,11,1000,500,565,1,2066
23:03:12,11,1000,491,565,1,2057
23:03:13,11,1000,501,565,0,2066
23:03:14,11,1000,493,565,1,2059
23:03:15,11,0,0,0,0,0
23:03:16,11,1000,496,565,0,2061
23:03:17,11,999,492,565,1,2057
23:03:18,11,1000,499,565,1,2065
23:03:19,11,1000,510,564,0,2074
23:03:20,11,1000,501,564,1,2066
23:03:21,11,1000,494,564,1,2059
23:03:22,11,1000,499,564,1,2064
23:03:23,11,999,492,564,1,2056
23:03:24,11,0,0,0,0,0
23:03:25,11,1000,493,564,0,2057
23:03:26,11,1000,501,564,1,2066
23:03:27,11,1000,496,564,0,2060
23:03:28,11,1000,487,564,2,2053
23:03:29,11,1000,495,564,0,2059
23:03:30,11,1000,493,563,0,2056
23:03:31,11,1000,499,563,1,2063
23:03:32,11,1000,492,563,0,2055
23:03:33,11,1000,492,563,1,2056
23:03:34,11,1000,495,563,0,2058
23:03:35,11,1000,494,562,0,2056
23:03:36,11,1000,501,562,0,2063
23:03:37,11,1000,492,562,0,2054
23:03:38,11,1000,496,562,0,2058
23:03:39,11,1000,495,562,1,2058
23:03:40,11,1000,496,562,1,2059
23:03:41,11,1000,488,562,0,2050
23:03:42,11,1000,494,562,1,2057
23:03:43,11,1001,495,562,2,2060
23:03:44,11,1000,495,562,1,2058
23:03:45,11,999,494,562,1,2056
23:03:46,11,1000,493,562,1,2056
23:03:47,11,1000,491,562,2,2055
23:03:48,11,1000,499,562,1,2062
23:03:49,11,1000,499,561,1,2061
23:03:50,11,999,500,561,0,2060
23:03:51,11,1000,495,562,2,2059
23:03:52,11,1000,500,561,1,2062
23:03:53,11,1000,497,561,1,2059
23:03:54,11,1000,498,561,1,2060
23:03:55,11,1000,488,561,1,2050
23:03:56,11,999,491,560,1,2051
23:03:57,11,1000,494,560,1,2055
23:03:58,11,999,494,560,1,2054
23:03:59,11,1000,490,560,0,2050
23:04:00,11,999,496,560,0,2055
23:04:01,11,1000,496,559,1,2056
23:04:02,11,1000,494,559,1,2054
23:04:03,11,1000,501,559,1,2061
23:04:04,11,1000,494,558,0,2052
23:04:05,11,0,0,0,0,0
23:04:06,11,1000,493,557,0,2050
23:04:07,11,1000,499,557,1,2057
23:04:08,11,1000,500,557,0,2057
23:04:09,11,1000,496,556,0,2052
23:04:10,11,1000,498,557,0,2055
23:04:11,11,1000,489,556,1,2046
23:04:12,11,1000,492,556,1,2049
23:04:13,11,1000,490,555,2,2047
23:04:14,11,1000,504,554,2,2060
23:04:15,11,1000,500,554,0,2054
23:04:16,11,1000,497,554,0,2051
23:04:17,11,999,501,554,1,2055
23:04:18,11,1000,497,554,0,2051
23:04:19,11,1000,491,554,0,2045
23:04:20,11,1000,491,554,1,2046
23:04:21,11,1000,491,554,1,2046
23:04:22,11,999,496,554,1,2050
23:04:23,11,1000,496,554,1,2051
23:04:24,11,999,495,554,1,2049
23:04:25,11,999,496,554,1,2050
23:04:26,11,1000,498,554,0,2052
23:04:27,11,1000,496,553,1,2050
23:04:28,11,1000,496,553,0,2049
23:04:29,11,999,495,554,1,2049
23:04:30,11,999,494,553,1,2047
23:04:31,11,1000,501,553,1,2055
23:04:32,11,999,490,553,0,2042
23:04:33,11,0,0,0,0,0
23:04:34,11,999,498,553,1,2051
23:04:35,11,999,493,553,0,2045
23:04:36,11,999,497,552,0,2048
23:04:37,11,999,495,552,1,2047
23:04:38,11,999,495,552,1,2047
23:04:39,11,999,496,551,0,2046
23:04:40,11,999,491,551,0,2041
23:04:41,11,999,496,551,1,2047
23:04:42,11,999,495,551,1,2046
23:04:43,11,0,0,0,0,0
23:04:44,11,999,494,550,0,2043
23:04:45,11,1000,496,550,1,2047
23:04:46,11,999,494,550,0,2043
23:04:47,11,1000,500,550,0,2050
23:04:48,11,1000,491,550,0,2041
23:04:49,11,999,497,550,0,2046
23:04:50,11,999,499,549,1,2048
23:04:51,11,999,496,549,0,2044
23:04:52,11,999,497,549,1,2046
23:04:53,11,0,0,0,0,0
23:04:54,11,999,495,549,1,2044
23:04:55,11,999,496,549,0,2044
23:04:56,11,999,492,549,1,2041
23:04:57,11,1000,497,549,2,2048
23:04:58,11,999,495,549,1,2044
23:04:59,11,999,496,549,0,2044
23:05:00,11,999,491,549,1,2040
23:05:01,11,1000,497,550,1,2048
23:05:02,11,1000,490,550,2,2042
23:05:03,11,1000,499,550,0,2049
23:05:04,11,1000,497,550,1,2048
23:05:05,11,999,493,550,0,2042
23:05:06,11,0,0,0,0,0
23:05:07,11,999,494,550,1,2044
23:05:08,11,999,494,550,0,2043
23:05:09,11,999,500,550,0,2049
23:05:10,11,1000,502,550,2,2054
23:05:11,11,999,497,550,0,2046
23:05:12,11,999,497,550,1,2047
23:05:13,11,999,498,550,0,2047
23:05:14,11,999,496,550,1,2046
23:05:15,11,1000,502,550,0,2052
23:05:16,11,999,493,549,0,2041
23:05:17,11,999,502,550,1,2052
23:05:18,11,1000,495,550,1,2046
23:05:19,11,1000,497,550,1,2048
23:05:20,11,1000,493,549,0,2042
23:05:21,11,1000,497,550,1,2048
23:05:22,11,1000,496,550,1,2047
23:05:23,11,999,496,550,0,2045
23:05:24,11,999,491,550,1,2041
23:05:25,11,999,493,550,1,2043
23:05:26,11,1000,496,550,1,2047
23:05:27,11,1000,493,550,0,2043
23:05:28,11,999,497,550,1,2047
23:05:29,11,1000,487,549,1,2037
23:05:30,11,1000,491,549,1,2041
23:05:31,11,1000,489,549,1,2039
23:05:32,11,1000,498,549,1,2048
23:05:33,11,999,497,549,0,2045
23:05:34,11,0,0,0,0,0
23:05:35,11,1000,495,549,0,2044
23:05:36,11,1000,495,549,1,2045
23:05:37,11,1000,494,549,0,2043
23:05:38,11,1000,493,548,1,2042
23:05:39,11,1000,491,548,1,2040
23:05:40,11,1000,497,548,1,2046
23:05:41,11,1000,494,548,0,2042
23:05:42,11,1000,489,548,0,2037
23:05:43,11,1000,496,548,0,2044
23:05:44,11,0,0,0,0,0
23:05:45,11,1000,499,547,1,2047
23:05:46,11,1000,493,546,0,2039
23:05:47,11,1000,506,544,1,2051
23:05:48,11,1000,500,544,1,2045
23:05:49,11,1000,494,543,0,2037
23:05:50,11,1000,502,543,0,2045
23:05:51,11,1000,496,543,1,2040
23:05:52,11,1000,495,544,1,2040
23:05:53,11,1000,495,544,0,2039
23:05:54,11,1000,494,544,1,2039
23:05:55,11,1000,498,544,1,2043
23:05:56,11,1000,494,544,1,2039
23:05:57,11,1000,497,544,2,2043
23:05:58,11,1000,495,544,0,2039
23:05:59,11,1000,496,544,1,2041
23:06:00,11,1000,497,544,1,2042
23:06:01,11,1000,496,544,1,2041
23:06:02,11,999,493,544,1,2037
23:06:03,11,1000,503,544,0,2047
23:06:04,11,1000,495,544,1,2040
23:06:05,11,999,494,544,0,2037
23:06:06,11,1000,494,544,0,2038
23:06:07,11,999,497,544,1,2041
23:06:08,11,1000,495,543,1,2039
23:06:09,11,1000,498,543,0,2041
23:06:10,11,1000,506,543,1,2050
23:06:11,11,1000,496,543,1,2040
23:06:12,11,1000,497,543,0,2040
23:06:13,11,1000,494,543,1,2038
23:06:14,11,1000,497,544,1,2042
23:06:15,11,0,0,0,0,0
23:06:16,11,999,496,544,0,2039
23:06:17,11,1000,496,544,1,2041
23:06:18,11,1000,503,544,0,2047
23:06:19,11,1000,493,544,1,2038
23:06:20,11,0,0,0,0,0
23:06:21,11,0,0,0,0,0
23:06:22,11,1000,493,544,0,2037
23:06:23,11,1000,496,544,1,2041
23:06:24,11,1000,497,544,0,2041
23:06:25,11,999,500,544,1,2044
23:06:26,11,999,497,544,0,2040
23:06:27,11,1000,492,544,1,2037
23:06:28,11,999,494,544,1,2038
23:06:29,11,999,503,544,1,2047
23:06:30,11,1000,494,544,1,2039
23:06:31,11,1000,489,544,1,2034
23:06:32,11,1000,499,544,1,2044
23:06:33,11,1000,493,544,1,2038
23:06:34,11,999,495,544,1,2039
23:06:35,11,1000,525,544,0,2069
23:06:36,11,999,495,544,0,2038
23:06:37,11,1000,493,545,1,2039
23:06:38,11,1000,493,544,0,2037
23:06:39,11,999,496,545,0,2040
23:06:40,11,999,499,544,1,2043
23:06:41,11,1000,498,545,1,2044
23:06:42,11,0,0,0,0,0
23:06:43,11,1000,499,545,0,2044
23:06:44,11,1000,489,545,0,2034
23:06:45,11,1000,479,545,1,2025
23:06:46,11,999,494,545,1,2039
23:06:47,11,1000,501,545,0,2046
23:06:48,11,1000,499,545,1,2045
23:06:49,11,1000,495,545,0,2040
23:06:50,11,999,491,545,1,2036
23:06:51,11,1000,495,545,1,2041
23:06:52,11,1000,500,545,1,2046
23:06:53,11,1000,494,545,0,2039
23:06:54,11,0,0,0,0,0
23:06:55,11,999,516,545,1,2061
23:06:56,11,0,0,0,0,0
23:06:57,11,1000,493,545,0,2038
23:06:58,11,1000,493,545,1,2039
23:06:59,11,1000,477,545,0,2022
23:07:00,11,1000,500,545,0,2045
23:07:01,11,0,0,0,0,0
23:07:02,11,1000,492,544,0,2036
23:07:03,11,999,502,544,0,2045
23:07:04,11,999,500,544,2,2045
23:07:05,11,1000,501,545,0,2046
22:50:41,12,0,0,0,0,0
22:50:42,12,0,0,0,0,0
22:50:43,12,0,0,0,0,0
22:50:44,12,0,0,0,0,0
22:50:45,12,0,0,0,0,0
22:50:46,12,0,0,0,0,0
22:50:47,12,0,0,0,0,0
22:50:48,12,0,0,0,0,0
22:50:49,12,1000,524,537,0,2061
22:50:50,12,0,0,0,0,0
22:50:51,12,0,0,0,0,0
22:50:52,12,0,0,0,0,0
22:50:53,12,0,0,0,0,0
22:50:54,12,1000,480,538,0,2018
22:50:55,12,0,0,0,0,0
22:50:56,12,0,0,0,0,0
22:50:57,12,0,0,0,0,0
22:50:58,12,0,0,0,0,0
22:50:59,12,0,0,0,0,0
22:51:00,12,1000,487,538,0,2025
22:51:01,12,0,0,0,0,0
22:51:02,12,0,0,0,0,0
22:51:03,12,1000,515,538,0,2053
22:51:04,12,0,0,0,0,0
22:51:05,12,0,0,0,0,0
22:51:06,12,0,0,0,0,0
22:51:07,12,0,0,0,0,0
22:51:08,12,0,0,0,0,0
22:51:09,12,0,0,0,0,0
22:51:10,12,0,0,0,0,0
22:51:11,12,1000,508,538,0,2046
22:51:12,12,0,0,0,0,0
22:51:13,12,0,0,0,0,0
22:51:14,12,1001,485,539,0,2025
22:51:15,12,0,0,0,0,0
22:51:16,12,0,0,0,0,0
22:51:17,12,0,0,0,0,0
22:51:18,12,1001,494,539,0,2034
22:51:19,12,0,0,0,0,0
22:51:20,12,0,0,0,0,0
22:51:21,12,1000,324,539,0,1863
22:51:22,12,0,0,0,0,0
22:51:23,12,0,0,0,0,0
22:51:24,12,1000,447,539,0,1986
22:51:25,12,0,0,0,0,0
22:51:26,12,0,0,0,0,0
22:51:27,12,0,0,0,0,0
22:51:28,12,0,0,0,0,0
22:51:29,12,0,0,0,0,0
22:51:30,12,0,0,0,0,0
22:51:31,12,0,0,0,0,0
22:51:32,12,0,0,0,0,0
22:51:33,12,0,0,0,0,0
22:51:34,12,0,0,0,0,0
22:51:35,12,0,0,0,0,0
22:51:36,12,0,0,0,0,0
22:51:37,12,0,0,0,0,0
22:51:38,12,0,0,0,0,0
22:51:39,12,0,0,0,0,0
22:51:40,12,0,0,0,0,0
22:51:41,12,0,0,0,0,0
22:51:42,12,0,0,0,0,0
22:51:43,12,0,0,0,0,0
22:51:44,12,0,0,0,0,0
22:51:45,12,0,0,0,0,0
22:51:46,12,0,0,0,0,0
22:51:47,12,0,0,0,0,0
22:51:48,12,1000,513,539,351,2403
22:51:49,12,0,0,0,0,0
22:51:50,12,0,0,0,0,0
22:51:51,12,1001,495,539,523,2558
22:51:52,12,0,0,0,0,0
22:51:53,12,0,0,0,0,0
22:51:54,12,0,0,0,0,0
22:51:55,12,0,0,0,0,0
22:51:56,12,0,0,0,0,0
22:51:57,12,0,0,0,0,0
22:51:58,12,1008,514,577,387,2486
22:51:59,12,0,0,0,0,0
22:52:00,12,0,0,0,0,0
22:52:01,12,0,0,0,0,0
22:52:02,12,0,0,0,0,0
22:52:03,12,0,0,0,0,0
22:52:04,12,0,0,0,0,0
22:52:05,12,0,0,0,0,0
22:52:06,12,1005,495,646,702,2848
22:52:07,12,1005,495,646,515,2661
22:52:08,12,0,0,0,0,0
22:52:09,12,0,0,0,0,0
22:52:10,12,1001,507,649,577,2734
22:52:11,12,1001,495,648,333,2477
22:52:12,12,1001,481,647,571,2700
22:52:13,12,1002,485,651,680,2818
22:52:14,12,1002,505,651,555,2713
22:52:15,12,1002,518,657,445,2622
22:52:16,12,1001,489,658,343,2491
22:52:17,12,1001,496,660,650,2807
22:52:18,12,1000,494,660,486,2640
22:52:19,12,1000,464,667,425,2556
22:52:20,12,1000,504,668,424,2596
22:52:21,12,0,0,0,0,0
22:52:22,12,1000,483,668,399,2550
22:52:23,12,1000,496,668,520,2684
22:52:24,12,1000,500,682,530,2712
22:52:25,12,999,513,680,526,2718
22:52:26,12,1000,480,679,480,2639
22:52:27,12,1000,507,688,460,2655
22:52:28,12,0,0,0,0,0
22:52:29,12,1000,507,715,665,2887
22:52:30,12,1000,541,784,537,2862
22:52:31,12,1000,489,770,266,2525
22:52:32,12,0,0,0,0,0
22:52:33,12,0,0,0,0,0
22:52:34,12,0,0,0,0,0
22:52:35,12,0,0,0,0,0
22:52:36,12,998,504,751,850,3103
22:52:37,12,999,526,762,918,3205
22:52:38,12,997,479,775,834,3085
22:52:39,12,997,480,765,907,3149
22:52:40,12,998,485,764,813,3060
22:52:41,12,998,474,761,832,3065
22:52:42,12,997,495,760,883,3135
22:52:43,12,998,492,757,844,3091
22:52:44,12,998,592,755,858,3203
22:52:45,12,998,528,753,872,3151
22:52:46,12,998,495,750,881,3124
22:52:47,12,998,497,746,888,3129
22:52:48,12,998,500,746,868,3112
22:52:49,12,998,489,747,849,3083
22:52:50,12,998,448,760,918,3124
22:52:51,12,997,507,771,876,3151
22:52:52,12,997,482,763,809,3051
22:52:53,12,998,499,768,841,3106
22:52:54,12,997,483,771,882,3133
22:52:55,12,997,485,769,837,3088
22:52:56,12,997,491,765,898,3151
22:52:57,12,997,513,763,874,3147
22:52:58,12,997,498,761,905,3161
22:52:59,12,998,454,759,794,3005
22:53:00,12,0,0,0,0,0
22:53:01,12,997,509,776,844,3126
22:53:02,12,997,499,773,863,3132
22:53:03,12,997,488,773,877,3135
22:53:04,12,0,0,0,0,0
22:53:05,12,0,0,0,0,0
22:53:06,12,997,481,797,936,3211
22:53:07,12,996,506,797,834,3133
22:53:08,12,998,520,792,757,3067
22:53:09,12,998,530,792,764,3084
22:53:10,12,1000,512,791,859,3162
22:53:11,12,1004,488,798,897,3187
22:53:12,12,1004,484,799,880,3167
22:53:13,12,1001,507,799,878,3185
22:53:14,12,999,509,798,902,3208
22:53:15,12,999,507,797,827,3130
22:53:16,12,998,503,796,870,3167
22:53:17,12,999,475,796,936,3206
22:53:18,12,998,507,795,881,3181
22:53:19,12,997,496,795,885,3173
22:53:20,12,997,497,794,838,3126
22:53:21,12,998,507,793,805,3103
22:53:22,12,998,484,791,905,3178
22:53:23,12,999,494,789,860,3142
22:53:24,12,998,492,787,805,3082
22:53:25,12,998,497,786,850,3131
22:53:26,12,998,497,784,850,3129
22:53:27,12,998,502,783,907,3190
22:53:28,12,998,496,782,868,3144
22:53:29,12,998,497,780,877,3152
22:53:30,12,999,481,778,894,3152
22:53:31,12,998,488,777,857,3120
22:53:32,12,998,497,775,828,3098
22:53:33,12,998,511,773,857,3139
22:53:34,12,998,501,772,866,3137
22:53:35,12,0,0,0,0,0
22:53:36,12,1000,479,773,878,3130
22:53:37,12,0,0,0,0,0
22:53:38,12,1005,500,786,876,3167
22:53:39,12,1000,507,787,894,3188
22:53:40,12,998,496,793,875,3162
22:53:41,12,997,495,793,821,3106
22:53:42,12,998,506,791,817,3112
22:53:43,12,998,490,791,883,3162
22:53:44,12,998,523,790,918,3229
22:53:45,12,998,491,788,877,3154
22:53:46,12,997,484,786,916,3183
22:53:47,12,997,478,785,897,3157
22:53:48,12,998,486,785,843,3112
22:53:49,12,997,491,785,933,3206
22:53:50,12,998,496,783,910,3187
22:53:51,12,997,501,783,899,3180
22:53:52,12,0,0,0,0,0
22:53:53,12,998,488,779,863,3128
22:53:54,12,998,504,777,808,3087
22:53:55,12,998,494,775,849,3116
22:53:56,12,998,482,774,844,3098
22:53:57,12,998,468,771,845,3082
22:53:58,12,998,501,770,880,3149
22:53:59,12,998,493,769,894,3154
22:54:00,12,998,492,766,878,3134
22:54:01,12,998,491,765,833,3087
22:54:02,12,998,489,765,787,3039
22:54:03,12,998,488,763,924,3173
22:54:04,12,998,496,761,937,3192
22:54:05,12,998,499,761,885,3143
22:54:06,12,998,496,760,773,3027
22:54:07,12,998,487,759,923,3167
22:54:08,12,1000,496,757,895,3148
22:54:09,12,999,521,756,933,3209
22:54:10,12,998,510,754,942,3204
22:54:11,12,998,482,753,862,3095
22:54:12,12,998,497,752,882,3129
22:54:13,12,0,0,0,0,0
22:54:14,12,998,504,749,878,3129
22:54:15,12,999,504,747,896,3146
22:54:16,12,999,488,748,889,3124
22:54:17,12,999,504,749,943,3195
22:54:18,12,999,509,749,862,3119
22:54:19,12,999,496,750,885,3130
22:54:20,12,999,498,753,949,3199
22:54:21,12,1000,493,753,814,3060
22:54:22,12,999,502,756,886,3143
22:54:23,12,998,500,755,770,3023
22:54:24,12,1000,498,757,847,3102
22:54:25,12,999,504,753,844,3100
22:54:26,12,999,504,755,840,3098
22:54:27,12,999,496,755,879,3129
22:54:28,12,998,489,753,846,3086
22:54:29,12,998,495,751,828,3072
22:54:30,12,998,480,750,966,3194
22:54:31,12,998,496,749,858,3101
22:54:32,12,998,491,749,856,3094
22:54:33,12,998,499,747,832,3076
22:54:34,12,998,499,744,874,3115
22:54:35,12,999,491,743,938,3171
22:54:36,12,998,496,742,871,3107
22:54:37,12,998,500,741,877,3116
22:54:38,12,998,498,741,893,3130
22:54:39,12,998,494,741,862,3095
22:54:40,12,998,495,741,892,3126
22:54:41,12,998,498,742,906,3144
22:54:42,12,0,0,0,0,0
22:54:43,12,998,500,744,865,3107
22:54:44,12,999,508,747,874,3128
22:54:45,12,998,483,747,946,3174
22:54:46,12,998,489,745,854,3086
22:54:47,12,998,492,746,928,3164
22:54:48,12,998,488,746,877,3109
22:54:49,12,998,501,746,930,3175
22:54:50,12,997,510,747,868,3122
22:54:51,12,998,502,749,904,3153
22:54:52,12,997,499,754,888,3138
22:54:53,12,998,503,759,915,3175
22:54:54,12,998,500,755,993,3246
22:54:55,12,997,495,751,925,3168
22:54:56,12,997,509,752,926,3184
22:54:57,12,997,508,752,898,3155
22:54:58,12,997,498,751,836,3082
22:54:59,12,997,498,750,772,3017
22:55:00,12,997,498,750,877,3122
22:55:01,12,998,494,749,929,3170
22:55:02,12,998,501,748,813,3060
22:55:03,12,998,500,746,866,3110
22:55:04,12,998,496,746,896,3136
22:55:05,12,998,496,746,890,3130
22:55:06,12,998,500,745,815,3058
22:55:07,12,998,490,744,877,3109
22:55:08,12,998,502,744,872,3116
22:55:09,12,999,482,743,818,3042
22:55:10,12,0,0,0,0,0
22:55:11,12,999,495,739,881,3114
22:55:12,12,999,492,737,897,3125
22:55:13,12,0,0,0,0,0
22:55:14,12,999,513,736,840,3088
22:55:15,12,999,503,735,882,3119
22:55:16,12,998,499,734,880,3111
22:55:17,12,999,507,733,851,3090
22:55:18,12,998,498,732,894,3122
22:55:19,12,999,445,730,798,2972
22:55:20,12,999,499,728,880,3106
22:55:21,12,1000,476,727,899,3102
22:55:22,12,999,495,728,974,3196
22:55:23,12,0,0,0,0,0
22:55:24,12,999,491,724,967,3181
22:55:25,12,999,500,723,867,3089
22:55:26,12,0,0,0,0,0
22:55:27,12,0,0,0,0,0
22:55:28,12,998,495,720,845,3058
22:55:29,12,998,511,718,837,3064
22:55:30,12,998,511,717,899,3125
22:55:31,12,998,499,715,822,3034
22:55:32,12,998,494,713,907,3112
22:55:33,12,999,500,712,913,3124
22:55:34,12,999,506,710,914,3129
22:55:35,12,999,496,710,863,3068
22:55:36,12,999,496,707,934,3136
22:55:37,12,999,499,705,900,3103
22:55:38,12,999,499,705,902,3105
22:55:39,12,999,493,705,943,3140
22:55:40,12,999,493,705,903,3100
22:55:41,12,999,497,703,953,3152
22:55:42,12,999,508,701,807,3015
22:55:43,12,999,491,700,889,3079
22:55:44,12,999,497,699,868,3063
22:55:45,12,999,506,699,910,3114
22:55:46,12,999,491,697,862,3049
22:55:47,12,999,488,696,877,3060
22:55:48,12,0,0,0,0,0
22:55:49,12,999,499,694,926,3118
22:55:50,12,999,498,694,865,3056
22:55:51,12,999,497,694,846,3036
22:55:52,12,999,496,692,843,3030
22:55:53,12,999,500,691,850,3040
22:55:54,12,999,495,690,891,3075
22:55:55,12,999,492,689,915,3095
22:55:56,12,999,484,688,872,3043
22:55:57,12,999,491,689,860,3039
22:55:58,12,998,491,689,867,3045
22:55:59,12,999,495,688,933,3115
22:56:00,12,999,485,687,809,2980
22:56:01,12,999,487,687,821,2994
22:56:02,12,998,497,685,844,3024
22:56:03,12,999,499,685,931,3114
22:56:04,12,999,495,685,870,3049
22:56:05,12,999,501,684,882,3066
22:56:06,12,999,498,683,913,3093
22:56:07,12,999,488,682,788,2957
22:56:08,12,999,488,681,851,3019
22:56:09,12,999,486,680,881,3046
22:56:10,12,999,506,680,863,3048
22:56:11,12,999,489,680,911,3079
22:56:12,12,999,493,680,910,3082
22:56:13,12,999,497,678,911,3085
22:56:14,12,999,488,677,834,2998
22:56:15,12,999,494,677,799,2969
22:56:16,12,999,487,676,900,3062
22:56:17,12,999,493,676,895,3063
22:56:18,12,998,502,675,721,2896
22:56:19,12,999,498,674,567,2738
22:56:20,12,999,508,674,429,2610
22:56:21,12,999,498,674,560,2731
22:56:22,12,999,488,674,450,2611
22:56:23,12,998,495,675,575,2743
22:56:24,12,999,496,676,477,2648
22:56:25,12,999,496,675,570,2740
22:56:26,12,999,499,676,418,2592
22:56:27,12,999,505,677,676,2857
22:56:28,12,999,497,677,610,2783
22:56:29,12,998,497,676,549,2720
22:56:30,12,999,494,677,281,2451
22:56:31,12,998,500,676,631,2805
22:56:32,12,999,494,676,368,2537
22:56:33,12,999,495,676,417,2587
22:56:34,12,999,498,676,717,2890
22:56:35,12,1000,494,675,576,2745
22:56:36,12,999,510,674,486,2669
22:56:37,12,999,503,674,543,2719
22:56:38,12,999,500,673,594,2766
22:56:39,12,999,498,672,530,2699
22:56:40,12,999,501,672,587,2759
22:56:41,12,999,489,672,562,2722
22:56:42,12,0,0,0,0,0
22:56:43,12,999,494,670,679,2842
22:56:44,12,999,485,670,670,2824
22:56:45,12,999,487,670,615,2771
22:56:46,12,999,488,672,447,2606
22:56:47,12,999,483,672,508,2662
22:56:48,12,999,499,673,581,2752
22:56:49,12,999,499,674,551,2723
22:56:50,12,999,481,675,534,2689
22:56:51,12,999,487,675,644,2805
22:56:52,12,999,493,676,595,2763
22:56:53,12,999,498,676,454,2627
22:56:54,12,999,501,675,572,2747
22:56:55,12,999,500,674,531,2704
22:56:56,12,999,493,674,535,2701
22:56:57,12,999,496,674,446,2615
22:56:58,12,999,486,673,568,2726
22:56:59,12,999,500,672,905,3076
22:57:00,12,0,0,0,0,0
22:57:01,12,999,505,672,875,3051
22:57:02,12,999,495,672,867,3033
22:57:03,12,1000,500,672,921,3093
22:57:04,12,999,495,672,894,3060
22:57:05,12,999,492,672,890,3053
22:57:06,12,1000,505,672,904,3081
22:57:07,12,999,486,671,956,3112
22:57:08,12,1000,490,671,930,3091
22:57:09,12,1000,489,671,912,3072
22:57:10,12,1000,497,673,906,3076
22:57:11,12,1000,492,675,905,3072
22:57:12,12,1000,494,675,891,3060
22:57:13,12,1000,487,674,880,3041
22:57:14,12,1000,496,674,893,3063
22:57:15,12,1000,491,674,906,3071
22:57:16,12,1000,498,673,920,3091
22:57:17,12,1000,487,671,900,3058
22:57:18,12,1000,493,669,911,3073
22:57:19,12,1001,490,668,872,3031
22:57:20,12,0,0,0,0,0
22:57:21,12,1001,494,668,501,2664
22:57:22,12,1000,498,670,557,2725
22:57:23,12,1000,491,672,504,2667
22:57:24,12,1000,486,670,460,2616
22:57:25,12,1001,499,669,460,2629
22:57:26,12,999,501,668,526,2694
22:57:27,12,998,487,666,502,2653
22:57:28,12,997,500,664,514,2675
22:57:29,12,0,0,0,0,0
22:57:30,12,997,492,662,548,2699
22:57:31,12,997,491,661,351,2500
22:57:32,12,997,499,661,519,2676
22:57:33,12,997,486,660,475,2618
22:57:34,12,997,493,659,420,2569
22:57:35,12,997,499,658,362,2516
22:57:36,12,998,497,658,338,2491
22:57:37,12,997,502,657,477,2633
22:57:38,12,997,492,655,472,2616
22:57:39,12,998,496,655,443,2592
22:57:40,12,997,492,654,614,2757
22:57:41,12,999,513,654,571,2737
22:57:42,12,997,486,657,541,2681
22:57:43,12,1000,511,669,379,2559
22:57:44,12,999,500,677,537,2713
22:57:45,12,1000,483,672,469,2624
22:57:46,12,1000,489,670,513,2672
22:57:47,12,1001,500,669,502,2672
22:57:48,12,1000,490,667,427,2584
22:57:49,12,1000,485,666,472,2623
22:57:50,12,1000,496,665,412,2573
22:57:51,12,1000,494,664,430,2588
22:57:52,12,1000,500,664,556,2720
22:57:53,12,1000,474,664,557,2695
22:57:54,12,1001,490,662,557,2710
22:57:55,12,1001,475,659,544,2679
22:57:56,12,1001,502,659,549,2711
22:57:57,12,1000,489,658,496,2643
22:57:58,12,1000,497,657,436,2590
22:57:59,12,1000,491,656,506,2653
22:58:00,12,1001,485,655,559,2700
22:58:01,12,1001,391,653,424,2469
22:58:02,12,1001,506,652,854,3013
22:58:03,12,1000,491,652,929,3072
22:58:04,12,1001,556,652,925,3134
22:58:05,12,1000,486,652,950,3088
22:58:06,12,1000,489,649,864,3002
22:58:07,12,1000,486,648,934,3068
22:58:08,12,1001,504,647,847,2999
22:58:09,12,1001,477,646,891,3015
22:58:10,12,0,0,0,0,0
22:58:11,12,1000,501,644,844,2989
22:58:12,12,1001,482,643,852,2978
22:58:13,12,1000,489,642,944,3075
22:58:14,12,1001,507,642,917,3067
22:58:15,12,0,0,0,0,0
22:58:16,12,1000,497,642,887,3026
22:58:17,12,1000,495,645,911,3051
22:58:18,12,1000,494,645,860,2999
22:58:19,12,0,0,0,0,0
22:58:20,12,999,485,647,879,3010
22:58:21,12,1000,490,650,917,3057
22:58:22,12,999,483,651,928,3061
22:58:23,12,0,0,0,0,0
22:58:24,12,1000,484,653,994,3131
22:58:25,12,1000,492,653,902,3047
22:58:26,12,1001,476,653,941,3071
22:58:27,12,1000,489,653,908,3050
22:58:28,12,1000,496,652,929,3077
22:58:29,12,1000,492,652,902,3046
22:58:30,12,1000,501,651,892,3044
22:58:31,12,1000,491,650,931,3072
22:58:32,12,1001,498,650,959,3108
22:58:33,12,1001,492,649,938,3080
22:58:34,12,1000,499,648,920,3067
22:58:35,12,0,0,0,0,0
22:58:36,12,1001,491,647,489,2628
22:58:37,12,1001,495,645,463,2604
22:58:38,12,1001,501,645,447,2594
22:58:39,12,1000,492,645,653,2790
22:58:40,12,1000,496,643,507,2646
22:58:41,12,1001,493,643,368,2505
22:58:42,12,1000,499,641,563,2703
22:58:43,12,1000,479,641,723,2843
22:58:44,12,1000,486,640,518,2644
22:58:45,12,0,0,0,0,0
22:58:46,12,1001,512,638,731,2882
22:58:47,12,1001,484,637,537,2659
22:58:48,12,1000,489,636,563,2688
22:58:49,12,1000,496,634,428,2558
22:58:50,12,1000,493,634,477,2604
22:58:51,12,1001,492,634,464,2591
22:58:52,12,1000,494,633,518,2645
22:58:53,12,1000,507,632,926,3065
22:58:54,12,0,0,0,0,0
22:58:55,12,1000,499,632,923,3054
22:58:56,12,999,501,637,937,3074
22:58:57,12,1000,496,638,896,3030
22:58:58,12,1001,506,639,825,2971
22:58:59,12,1001,505,649,828,2983
22:59:00,12,999,491,650,901,3041
22:59:01,12,998,509,700,929,3136
22:59:02,12,997,498,706,825,3026
22:59:03,12,993,492,696,840,3021
22:59:04,12,996,491,691,960,3138
22:59:05,12,997,490,690,880,3057
22:59:06,12,997,495,691,898,3081
22:59:07,12,997,486,691,900,3074
22:59:08,12,997,494,691,826,3008
22:59:09,12,998,498,690,814,3000
22:59:10,12,997,507,689,882,3075
22:59:11,12,998,499,688,896,3081
22:59:12,12,998,487,687,998,3170
22:59:13,12,998,499,686,903,3086
22:59:14,12,998,493,686,929,3106
22:59:15,12,998,496,683,908,3085
22:59:16,12,997,486,681,921,3085
22:59:17,12,997,487,679,860,3023
22:59:18,12,0,0,0,0,0
22:59:19,12,998,495,679,891,3063
22:59:20,12,997,497,679,881,3054
22:59:21,12,997,500,678,888,3063
22:59:22,12,998,496,678,935,3107
22:59:23,12,997,496,678,857,3028
22:59:24,12,0,0,0,0,0
22:59:25,12,998,504,678,944,3124
22:59:26,12,998,501,679,923,3101
22:59:27,12,997,495,678,836,3006
22:59:28,12,997,486,678,900,3061
22:59:29,12,997,497,678,908,3080
22:59:30,12,997,498,676,901,3072
22:59:31,12,997,492,675,847,3011
22:59:32,12,997,485,675,850,3007
22:59:33,12,996,903,674,859,3432
22:59:34,12,998,501,673,902,3074
22:59:35,12,998,506,672,934,3110
22:59:36,12,997,264,670,914,2845
22:59:37,12,996,1006,670,977,3649
22:59:38,12,996,494,668,916,3074
22:59:39,12,999,461,666,939,3065
22:59:40,12,999,750,666,882,3297
22:59:41,12,999,649,663,947,3258
22:59:42,12,990,476,663,896,3025
22:59:43,12,998,244,661,912,2815
22:59:44,12,999,493,660,922,3074
22:59:45,12,997,488,659,861,3005
22:59:46,12,996,551,658,862,3067
22:59:47,12,0,0,0,0,0
22:59:48,12,996,500,656,914,3066
22:59:49,12,996,636,656,913,3201
22:59:50,12,997,499,654,930,3080
22:59:51,12,998,485,653,935,3071
22:59:52,12,998,747,652,905,3302
22:59:53,12,999,620,652,899,3170
22:59:54,12,999,484,652,871,3006
22:59:55,12,999,551,650,923,3123
22:59:56,12,999,437,650,916,3002
22:59:57,12,998,493,650,878,3019
22:59:58,12,998,490,648,884,3020
22:59:59,12,998,488,647,918,3051
23:00:00,12,999,491,646,958,3094
23:00:01,12,999,488,647,976,3110
23:00:02,12,998,494,645,880,3017
23:00:03,12,998,494,645,887,3024
23:00:04,12,998,491,644,924,3057
23:00:05,12,998,492,644,910,3044
23:00:06,12,0,0,0,0,0
23:00:07,12,998,481,642,910,3031
23:00:08,12,998,492,640,895,3025
23:00:09,12,998,496,641,877,3012
23:00:10,12,999,495,640,897,3031
23:00:11,12,998,495,639,902,3034
23:00:12,12,998,496,639,952,3085
23:00:13,12,998,499,639,852,2988
23:00:14,12,998,500,639,899,3036
23:00:15,12,999,486,642,909,3036
23:00:16,12,999,495,640,885,3019
23:00:17,12,999,488,638,915,3040
23:00:18,12,999,488,637,849,2973
23:00:19,12,998,494,635,894,3021
23:00:20,12,998,493,635,885,3011
23:00:21,12,0,0,0,0,0
23:00:22,12,998,512,632,905,3047
23:00:23,12,0,0,0,0,0
23:00:24,12,998,502,630,820,2950
23:00:25,12,998,488,630,877,2993
23:00:26,12,998,520,628,863,3009
23:00:27,12,998,495,628,884,3005
23:00:28,12,998,479,627,913,3017
23:00:29,12,0,0,0,0,0
23:00:30,12,998,495,627,942,3062
23:00:31,12,0,0,0,0,0
23:00:32,12,999,490,625,835,2949
23:00:33,12,998,491,623,902,3014
23:00:34,12,998,494,622,885,2999
23:00:35,12,998,499,623,939,3059
23:00:36,12,998,494,620,908,3020
23:00:37,12,998,495,619,891,3003
23:00:38,12,999,493,618,904,3014
23:00:39,12,999,497,617,955,3068
23:00:40,12,998,496,617,921,3032
23:00:41,12,999,493,618,968,3078
23:00:42,12,998,493,618,933,3042
23:00:43,12,998,499,619,964,3080
23:00:44,12,998,494,619,964,3075
23:00:45,12,0,0,0,0,0
23:00:46,12,998,494,617,940,3049
23:00:47,12,998,489,617,932,3036
23:00:48,12,998,496,618,944,3056
23:00:49,12,998,500,617,936,3051
23:00:50,12,998,489,615,959,3061
23:00:51,12,999,505,615,963,3082
23:00:52,12,999,497,614,945,3055
23:00:53,12,999,509,612,948,3068
23:00:54,12,999,492,610,956,3057
23:00:55,12,998,483,609,953,3043
23:00:56,12,998,496,613,968,3075
23:00:57,12,998,500,616,946,3060
23:00:58,12,998,492,616,152,2258
23:00:59,12,998,498,616,75,2187
23:01:00,12,998,499,617,230,2344
23:01:01,12,998,496,617,78,2189
23:01:02,12,998,497,617,146,2258
23:01:03,12,998,500,617,87,2202
23:01:04,12,998,496,616,127,2237
23:01:05,12,998,495,616,147,2256
23:01:06,12,998,499,615,93,2205
23:01:07,12,0,0,0,0,0
23:01:08,12,998,491,614,134,2237
23:01:09,12,998,494,614,124,2230
23:01:10,12,998,502,615,160,2275
23:01:11,12,998,490,614,113,2215
23:01:12,12,998,505,614,190,2307
23:01:13,12,998,498,613,147,2256
23:01:14,12,999,496,613,180,2288
23:01:15,12,998,516,613,93,2220
23:01:16,12,998,496,613,130,2237
23:01:17,12,998,481,613,110,2202
23:01:18,12,998,493,613,94,2198
23:01:19,12,998,496,612,3,2109
23:01:20,12,998,487,612,2,2099
23:01:21,12,998,495,611,2,2106
23:01:22,12,998,487,610,2,2097
23:01:23,12,998,490,610,3,2101
23:01:24,12,998,499,610,2,2109
23:01:25,12,998,499,609,2,2108
23:01:26,12,998,503,608,0,2109
23:01:27,12,998,491,608,2,2099
23:01:28,12,999,497,608,2,2106
23:01:29,12,998,494,608,3,2103
23:01:30,12,998,495,608,3,2104
23:01:31,12,998,488,607,3,2096
23:01:32,12,998,480,606,1,2085
23:01:33,12,998,509,605,2,2114
23:01:34,12,998,498,604,2,2102
23:01:35,12,998,507,604,0,2109
23:01:36,12,999,495,603,1,2098
23:01:37,12,998,489,603,2,2092
23:01:38,12,998,499,603,2,2102
23:01:39,12,998,492,603,2,2095
23:01:40,12,998,514,603,2,2117
23:01:41,12,998,512,602,2,2114
23:01:42,12,998,493,602,2,2095
23:01:43,12,998,474,602,2,2076
23:01:44,12,998,493,602,3,2096
23:01:45,12,998,494,602,2,2096
23:01:46,12,999,487,602,2,2090
23:01:47,12,0,0,0,0,0
23:01:48,12,998,496,602,5,2101
23:01:49,12,998,492,602,1,2093
23:01:50,12,998,481,602,5,2086
23:01:51,12,998,488,601,4,2091
23:01:52,12,999,501,601,4,2105
23:01:53,12,998,491,600,0,2089
23:01:54,12,998,500,600,0,2098
23:01:55,12,998,492,600,1,2091
23:01:56,12,998,471,599,1,2069
23:01:57,12,998,498,598,1,2095
23:01:58,12,999,505,598,2,2104
23:01:59,12,999,495,597,1,2092
23:02:00,12,998,504,597,2,2101
23:02:01,12,998,496,597,0,2091
23:02:02,12,998,503,597,1,2099
23:02:03,12,998,485,597,1,2081
23:02:04,12,998,500,597,1,2096
23:02:05,12,998,501,596,0,2095
23:02:06,12,998,505,595,1,2099
23:02:07,12,998,485,595,0,2078
23:02:08,12,998,493,594,1,2086
23:02:09,12,998,500,593,1,2092
23:02:10,12,998,494,592,1,2085
23:02:11,12,998,497,591,1,2087
23:02:12,12,998,496,590,0,2084
23:02:13,12,998,477,589,1,2065
23:02:14,12,998,476,587,1,2062
23:02:15,12,998,483,587,1,2069
23:02:16,12,998,505,587,1,2091
23:02:17,12,999,498,587,1,2085
23:02:18,12,998,485,586,1,2070
23:02:19,12,998,499,585,1,2083
23:02:20,12,998,492,584,0,2074
23:02:21,12,998,493,583,1,2075
23:02:22,12,998,490,583,1,2072
23:02:23,12,998,493,582,0,2073
23:02:24,12,998,490,581,1,2070
23:02:25,12,998,495,580,1,2074
23:02:26,12,0,0,0,0,0
23:02:27,12,998,495,579,0,2072
23:02:28,12,998,501,578,1,2078
23:02:29,12,998,492,578,1,2069
23:02:30,12,999,499,578,1,2077
23:02:31,12,999,492,577,1,2069
23:02:32,12,0,0,0,0,0
23:02:33,12,0,0,0,0,0
23:02:34,12,998,491,577,1,2067
23:02:35,12,998,488,576,1,2063
23:02:36,12,999,500,576,2,2077
23:02:37,12,0,0,0,0,0
23:02:38,12,998,492,575,0,2065
23:02:39,12,999,492,575,0,2066
23:02:40,12,998,493,575,1,2067
23:02:41,12,998,486,575,1,2060
23:02:42,12,998,493,574,0,2065
23:02:43,12,998,500,574,0,2072
23:02:44,12,999,498,574,0,2071
23:02:45,12,999,495,574,1,2069
23:02:46,12,999,493,573,1,2066
23:02:47,12,998,498,573,0,2069
23:02:48,12,999,500,573,0,2072
23:02:49,12,999,492,572,1,2064
23:02:50,12,999,495,572,0,2066
23:02:51,12,999,490,572,1,2062
23:02:52,12,998,495,572,0,2065
23:02:53,12,998,496,571,1,2066
23:02:54,12,998,497,571,0,2066
23:02:55,12,998,487,571,1,2057
23:02:56,12,997,487,571,1,2056
23:02:57,12,997,499,571,1,2068
23:02:58,12,997,494,571,1,2063
23:02:59,12,998,490,571,0,2059
23:03:00,12,998,477,571,2,2048
23:03:01,12,997,481,571,1,2050
23:03:02,12,997,496,571,1,2065
23:03:03,12,999,494,572,0,2065
23:03:04,12,999,500,571,1,2071
23:03:05,12,998,493,570,1,2062
23:03:06,12,999,491,570,0,2060
23:03:07,12,998,488,570,1,2057
23:03:08,12,998,496,569,0,2063
23:03:09,12,998,488,569,0,2055
23:03:10,12,998,498,568,0,2064
23:03:11,12,999,495,568,0,2062
23:03:12,12,998,495,568,1,2062
23:03:13,12,998,495,569,1,2063
23:03:14,12,998,467,569,0,2034
23:03:15,12,0,0,0,0,0
23:03:16,12,999,495,569,1,2064
23:03:17,12,998,480,568,0,2046
23:03:18,12,998,165,568,1,1732
23:03:19,12,998,504,568,1,2071
23:03:20,12,999,522,568,1,2090
23:03:21,12,998,497,568,0,2063
23:03:22,12,998,492,568,0,2058
23:03:23,12,999,500,568,0,2067
23:03:24,12,999,495,568,0,2062
23:03:25,12,999,487,568,0,2054
23:03:26,12,999,496,568,0,2063
23:03:27,12,999,503,568,2,2072
23:03:28,12,999,492,568,1,2060
23:03:29,12,999,495,568,1,2063
23:03:30,12,999,493,568,1,2061
23:03:31,12,999,490,568,2,2059
23:03:32,12,999,487,568,1,2055
23:03:33,12,0,0,0,0,0
23:03:34,12,999,503,568,2,2072
23:03:35,12,999,493,568,0,2060
23:03:36,12,999,492,568,0,2059
23:03:37,12,999,495,567,0,2061
23:03:38,12,999,496,567,0,2062
23:03:39,12,999,504,567,1,2071
23:03:40,12,999,496,567,0,2062
23:03:41,12,999,494,566,0,2059
23:03:42,12,999,493,566,0,2058
23:03:43,12,999,488,566,2,2055
23:03:44,12,999,493,566,1,2059
23:03:45,12,998,489,566,0,2053
23:03:46,12,998,487,566,1,2052
23:03:47,12,998,502,566,1,2067
23:03:48,12,998,497,566,0,2061
23:03:49,12,999,492,566,0,2057
23:03:50,12,998,663,566,1,2228
23:03:51,12,998,492,566,1,2057
23:03:52,12,998,479,566,2,2045
23:03:53,12,998,494,566,0,2058
23:03:54,12,998,491,566,1,2056
23:03:55,12,997,490,566,1,2054
23:03:56,12,997,487,566,0,2050
23:03:57,12,997,490,567,1,2055
23:03:58,12,998,493,566,1,2058
23:03:59,12,1000,489,566,0,2055
23:04:00,12,1000,495,566,1,2062
23:04:01,12,1001,497,566,1,2065
23:04:02,12,1001,499,566,2,2068
23:04:03,12,1000,496,565,1,2062
23:04:04,12,1000,494,565,1,2060
23:04:05,12,1001,490,565,1,2057
23:04:06,12,1000,497,564,1,2062
23:04:07,12,1000,470,564,1,2035
23:04:08,12,1001,489,563,1,2054
23:04:09,12,1000,494,563,1,2058
23:04:10,12,1001,494,563,1,2059
23:04:11,12,1001,495,562,1,2059
23:04:12,12,1001,490,562,1,2054
23:04:13,12,1001,490,562,0,2053
23:04:14,12,1001,493,561,1,2056
23:04:15,12,1000,489,561,0,2050
23:04:16,12,1001,488,560,0,2049
23:04:17,12,1001,491,560,1,2053
23:04:18,12,1001,492,560,0,2053
23:04:19,12,1001,494,560,0,2055
23:04:20,12,1001,497,559,1,2058
23:04:21,12,1001,494,559,1,2055
23:04:22,12,1000,494,559,0,2053
23:04:23,12,1001,492,559,1,2053
23:04:24,12,1000,496,559,1,2056
23:04:25,12,1000,488,558,1,2047
23:04:26,12,1000,493,558,1,2052
23:04:27,12,1000,490,558,1,2049
23:04:28,12,1000,499,558,1,2058
23:04:29,12,1000,490,558,0,2048
23:04:30,12,1000,494,558,0,2052
23:04:31,12,1000,496,558,0,2054
23:04:32,12,1000,492,558,1,2051
23:04:33,12,1000,496,557,0,2053
23:04:34,12,1000,496,557,1,2054
23:04:35,12,1000,500,557,1,2058
23:04:36,12,999,492,558,1,2050
23:04:37,12,999,494,557,1,2051
23:04:38,12,999,496,557,0,2052
23:04:39,12,999,494,557,1,2051
23:04:40,12,999,486,557,1,2043
23:04:41,12,999,497,556,1,2053
23:04:42,12,999,495,556,1,2051
23:04:43,12,999,489,556,1,2045
23:04:44,12,999,491,556,1,2047
23:04:45,12,999,497,556,1,2053
23:04:46,12,999,491,556,0,2046
23:04:47,12,999,487,556,0,2042
23:04:48,12,999,494,556,1,2050
23:04:49,12,999,485,556,1,2041
23:04:50,12,999,493,555,2,2049
23:04:51,12,999,493,556,1,2049
23:04:52,12,1000,496,555,1,2052
23:04:53,12,1000,498,555,1,2054
23:04:54,12,1000,494,555,0,2049
23:04:55,12,1000,506,555,1,2062
23:04:56,12,999,496,555,1,2051
23:04:57,12,1000,495,555,1,2051
23:04:58,12,1000,496,555,0,2051
23:04:59,12,1000,496,555,0,2051
23:05:00,12,1000,491,555,1,2047
23:05:01,12,1001,496,555,0,2052
23:05:02,12,1000,494,555,0,2049
23:05:03,12,1000,492,555,1,2048
23:05:04,12,1000,491,555,0,2046
23:05:05,12,1000,500,555,0,2055
23:05:06,12,1000,490,555,1,2046
23:05:07,12,1000,491,555,0,2046
23:05:08,12,1001,500,555,1,2057
23:05:09,12,1000,494,555,1,2050
23:05:10,12,1001,494,555,2,2052
23:05:11,12,1001,489,555,1,2046
23:05:12,12,1000,489,555,1,2045
23:05:13,12,1000,499,555,1,2055
23:05:14,12,1001,493,555,1,2050
23:05:15,12,1000,490,555,0,2045
23:05:16,12,1001,499,554,0,2054
23:05:17,12,1001,497,554,0,2052
23:05:18,12,1002,487,554,0,2043
23:05:19,12,1002,496,554,0,2052
23:05:20,12,1002,483,554,0,2039
23:05:21,12,1002,492,554,0,2048
23:05:22,12,1002,498,554,1,2055
23:05:23,12,1002,494,554,1,2051
23:05:24,12,1003,498,555,1,2057
23:05:25,12,1003,491,554,1,2049
23:05:26,12,1003,494,555,2,2054
23:05:27,12,1003,495,555,1,2054
23:05:28,12,1003,490,555,1,2049
23:05:29,12,1003,495,555,1,2054
23:05:30,12,1003,491,555,0,2049
23:05:31,12,1003,495,554,1,2053
23:05:32,12,1004,494,555,1,2054
23:05:33,12,1004,492,554,2,2052
23:05:34,12,1004,489,554,1,2048
23:05:35,12,1004,494,554,0,2052
23:05:36,12,1004,493,553,0,2050
23:05:37,12,1004,496,553,1,2054
23:05:38,12,1004,497,553,0,2054
23:05:39,12,1004,491,553,1,2049
23:05:40,12,1005,494,553,1,2053
23:05:41,12,1005,485,553,1,2044
23:05:42,12,1005,494,553,1,2053
23:05:43,12,1004,493,553,1,2051
23:05:44,12,1005,489,553,0,2047
23:05:45,12,1005,492,553,2,2052
23:05:46,12,1005,494,553,1,2053
23:05:47,12,1006,500,552,1,2059
23:05:48,12,1005,469,552,1,2027
23:05:49,12,1005,496,552,0,2053
23:05:50,12,1006,491,552,1,2050
23:05:51,12,1005,497,552,1,2055
23:05:52,12,1006,490,552,1,2049
23:05:53,12,1005,498,552,0,2055
23:05:54,12,1005,490,552,1,2048
23:05:55,12,1006,492,552,0,2050
23:05:56,12,1006,490,552,1,2049
23:05:57,12,1005,493,552,1,2051
23:05:58,12,1006,494,552,1,2053
23:05:59,12,1005,493,552,1,2051
23:06:00,12,0,0,0,0,0
23:06:01,12,1005,496,552,1,2054
23:06:02,12,1005,489,552,0,2046
23:06:03,12,1004,492,552,1,2049
23:06:04,12,1005,493,552,0,2050
23:06:05,12,1004,484,552,0,2040
23:06:06,12,1005,501,552,0,2058
23:06:07,12,1005,491,552,1,2049
23:06:08,12,1005,487,552,1,2045
23:06:09,12,1006,493,552,0,2051
23:06:10,12,1005,496,552,0,2053
23:06:11,12,1006,488,552,1,2047
23:06:12,12,1006,486,552,0,2044
23:06:13,12,1006,498,552,1,2057
23:06:14,12,1006,494,552,1,2053
23:06:15,12,1005,499,552,0,2056
23:06:16,12,999,494,551,0,2044
23:06:17,12,998,440,552,0,1990
23:06:18,12,1006,515,552,0,2073
23:06:19,12,0,0,0,0,0
23:06:20,12,1006,499,551,1,2057
23:06:21,12,1006,491,551,0,2048
23:06:22,12,1006,499,551,1,2057
23:06:23,12,1006,499,551,1,2057
23:06:24,12,1006,492,551,1,2050
23:06:25,12,1006,496,551,0,2053
23:06:26,12,1006,488,551,1,2046
23:06:27,12,1006,491,551,0,2048
23:06:28,12,1006,490,551,0,2047
23:06:29,12,1006,493,551,0,2050
23:06:30,12,1006,490,551,1,2048
23:06:31,12,1006,495,551,0,2052
23:06:32,12,1006,476,551,0,2033
23:06:33,12,1006,496,550,1,2053
23:06:34,12,1006,491,550,0,2047
23:06:35,12,0,0,0,0,0
23:06:36,12,1006,487,550,0,2043
23:06:37,12,1006,499,550,1,2056
23:06:38,12,1006,492,550,0,2048
23:06:39,12,0,0,0,0,0
23:06:40,12,1006,490,550,1,2047
23:06:41,12,1006,474,550,2,2032
23:06:42,12,1006,492,550,0,2048
23:06:43,12,1006,498,550,1,2055
23:06:44,12,1006,498,550,1,2055
23:06:45,12,1006,487,550,0,2043
23:06:46,12,1006,493,550,1,2050
23:06:47,12,1005,497,550,0,2052
23:06:48,12,1005,499,550,0,2054
23:06:49,12,1006,500,550,1,2057
23:06:50,12,1006,490,550,2,2048
23:06:51,12,1005,494,550,1,2050
23:06:52,12,1006,484,550,2,2042
23:06:53,12,0,0,0,0,0
23:06:54,12,1005,497,549,1,2052
23:06:55,12,1005,481,549,1,2036
23:06:56,12,0,0,0,0,0
23:06:57,12,1005,491,549,1,2046
23:06:58,12,0,0,0,0,0
23:06:59,12,1006,511,550,0,2067
23:07:00,12,1005,497,549,1,2052
23:07:01,12,1005,482,549,1,2037
23:07:02,12,1005,493,549,1,2048
23:07:03,12,1005,492,549,0,2046
23:07:04,12,1006,498,549,1,2054
23:07:05,12,1000,499,550,0,2049
22:50:41,13,0,0,0,0,0
22:50:42,13,0,0,0,0,0
22:50:43,13,996,522,544,0,2062
22:50:44,13,0,0,0,0,0
22:50:45,13,997,480,545,0,2022
22:50:46,13,997,494,545,0,2036
22:50:47,13,997,477,544,0,2018
22:50:48,13,997,474,544,0,2015
22:50:49,13,0,0,0,0,0
22:50:50,13,997,556,545,0,2098
22:50:51,13,998,485,544,0,2027
22:50:52,13,998,473,545,0,2016
22:50:53,13,0,0,0,0,0
22:50:54,13,997,489,545,0,2031
22:50:55,13,997,500,545,0,2042
22:50:56,13,0,0,0,0,0
22:50:57,13,997,457,545,0,1999
22:50:58,13,997,479,545,0,2021
22:50:59,13,0,0,0,0,0
22:51:00,13,997,463,545,0,2005
22:51:01,13,997,518,545,0,2060
22:51:02,13,997,471,544,0,2012
22:51:03,13,997,495,545,0,2037
22:51:04,13,998,483,545,0,2026
22:51:05,13,997,489,545,0,2031
22:51:06,13,0,0,0,0,0
22:51:07,13,997,485,545,0,2027
22:51:08,13,0,0,0,0,0
22:51:09,13,998,474,545,0,2017
22:51:10,13,997,488,545,0,2030
22:51:11,13,998,476,545,0,2019
22:51:12,13,997,483,545,0,2025
22:51:13,13,997,506,545,0,2048
22:51:14,13,998,483,545,0,2026
22:51:15,13,0,0,0,0,0
22:51:16,13,997,501,545,0,2043
22:51:17,13,997,488,545,0,2030
22:51:18,13,998,515,545,0,2058
22:51:19,13,996,475,545,0,2016
22:51:20,13,0,0,0,0,0
22:51:21,13,0,0,0,0,0
22:51:22,13,0,0,0,0,0
22:51:23,13,997,485,545,0,2027
22:51:24,13,0,0,0,0,0
22:51:25,13,998,480,545,0,2023
22:51:26,13,998,467,545,0,2010
22:51:27,13,997,484,545,0,2026
22:51:28,13,998,486,545,0,2029
22:51:29,13,998,483,545,0,2026
22:51:30,13,998,499,545,0,2042
22:51:31,13,998,470,546,0,2014
22:51:32,13,998,473,545,0,2016
22:51:33,13,997,487,545,0,2029
22:51:34,13,998,476,545,0,2019
22:51:35,13,0,0,0,0,0
22:51:36,13,998,487,545,0,2030
22:51:37,13,997,488,545,0,2030
22:51:38,13,0,0,0,0,0
22:51:39,13,997,480,545,63,2085
22:51:40,13,997,483,545,182,2207
22:51:41,13,997,480,545,495,2517
22:51:42,13,997,495,546,409,2447
22:51:43,13,998,484,545,528,2555
22:51:44,13,998,458,546,657,2659
22:51:45,13,997,485,546,716,2744
22:51:46,13,998,483,545,695,2721
22:51:47,13,999,485,545,443,2472
22:51:48,13,0,0,0,0,0
22:51:49,13,997,482,545,548,2572
22:51:50,13,998,473,545,292,2308
22:51:51,13,998,487,545,460,2490
22:51:52,13,997,486,546,550,2579
22:51:53,13,997,489,546,447,2479
22:51:54,13,998,484,549,473,2504
22:51:55,13,999,493,555,373,2420
22:51:56,13,1002,495,586,568,2651
22:51:57,13,1007,487,625,381,2500
22:51:58,13,1008,484,668,464,2624
22:51:59,13,1010,506,753,421,2690
22:52:00,13,1010,458,806,408,2682
22:52:01,13,1011,547,881,585,3024
22:52:02,13,1011,524,930,542,3007
22:52:03,13,1009,521,944,535,3009
22:52:04,13,0,0,0,0,0
22:52:05,13,522,540,519,455,2036
22:52:06,13,0,0,0,0,0
22:52:07,13,0,0,0,0,0
22:52:08,13,428,428,434,521,1811
22:52:09,13,439,434,440,293,1606
22:52:10,13,539,539,544,533,2155
22:52:11,13,532,536,539,511,2118
22:52:12,13,529,528,524,402,1983
22:52:13,13,546,526,540,641,2253
22:52:14,13,545,535,545,560,2185
22:52:15,13,537,543,550,518,2148
22:52:16,13,532,532,536,430,2030
22:52:17,13,543,502,551,367,1963
22:52:18,13,539,538,551,390,2018
22:52:19,13,534,512,520,522,2088
22:52:20,13,498,487,495,471,1951
22:52:21,13,537,505,535,503,2080
22:52:22,13,519,556,525,738,2338
22:52:23,13,562,488,565,465,2080
22:52:24,13,574,570,548,736,2428
22:52:25,13,558,580,566,464,2168
22:52:26,13,527,595,580,466,2168
22:52:27,13,616,610,641,496,2363
22:52:28,13,623,490,635,353,2101
22:52:29,13,628,469,642,350,2089
22:52:30,13,568,602,635,592,2397
22:52:31,13,584,597,587,497,2265
22:52:32,13,471,592,625,371,2059
22:52:33,13,0,0,0,0,0
22:52:34,13,549,578,623,905,2655
22:52:35,13,610,570,392,820,2392
22:52:36,13,522,459,544,953,2478
22:52:37,13,0,0,0,0,0
22:52:38,13,0,0,0,0,0
22:52:39,13,595,548,519,943,2605
22:52:40,13,606,550,608,867,2631
22:52:41,13,515,451,407,824,2197
22:52:42,13,0,0,0,0,0
22:52:43,13,0,0,0,0,0
22:52:44,13,0,0,0,0,0
22:52:45,13,0,0,0,0,0
22:52:46,13,504,432,513,786,2235
22:52:47,13,479,406,486,830,2201
22:52:48,13,456,270,468,845,2039
22:52:49,13,470,365,473,894,2202
22:52:50,13,0,0,0,0,0
22:52:51,13,481,384,477,877,2219
22:52:52,13,447,390,474,865,2176
22:52:53,13,0,0,0,0,0
22:52:54,13,0,0,0,0,0
22:52:55,13,0,0,0,0,0
22:52:56,13,0,0,0,0,0
22:52:57,13,0,0,0,0,0
22:52:58,13,0,0,0,0,0
22:52:59,13,0,0,0,0,0
22:53:00,13,0,0,0,0,0
22:53:01,13,0,0,0,0,0
22:53:02,13,0,0,0,0,0
22:53:03,13,0,0,0,0,0
22:53:04,13,0,0,0,0,0
22:53:05,13,0,0,0,0,0
22:53:06,13,0,0,0,0,0
22:53:07,13,0,0,0,0,0
22:53:08,13,0,0,0,0,0
22:53:09,13,0,0,0,0,0
22:53:10,13,0,0,0,0,0
22:53:11,13,0,0,0,0,0
22:53:12,13,0,0,0,0,0
22:53:13,13,0,0,0,0,0
22:53:14,13,0,0,0,0,0
22:53:15,13,0,0,0,0,0
22:53:16,13,0,0,0,0,0
22:53:17,13,0,0,0,0,0
22:53:18,13,0,0,0,0,0
22:53:19,13,0,0,0,0,0
22:53:20,13,0,0,0,0,0
22:53:21,13,0,0,0,0,0
22:53:22,13,0,0,0,0,0
22:53:23,13,0,0,0,0,0
22:53:24,13,0,0,0,0,0
22:53:25,13,0,0,0,0,0
22:53:26,13,0,0,0,0,0
22:53:27,13,0,0,0,0,0
22:53:28,13,0,0,0,0,0
22:53:29,13,0,0,0,0,0
22:53:30,13,0,0,0,0,0
22:53:31,13,0,0,0,0,0
22:53:32,13,0,0,0,0,0
22:53:33,13,0,0,0,0,0
22:53:34,13,0,0,0,0,0
22:53:35,13,0,0,0,0,0
22:53:36,13,0,0,0,0,0
22:53:37,13,0,0,0,0,0
22:53:38,13,0,0,0,0,0
22:53:39,13,0,0,0,0,0
22:53:40,13,0,0,0,0,0
22:53:41,13,0,0,0,0,0
22:53:42,13,0,0,0,0,0
22:53:43,13,0,0,0,0,0
22:53:44,13,0,0,0,0,0
22:53:45,13,0,0,0,0,0
22:53:46,13,0,0,0,0,0
22:53:47,13,0,0,0,0,0
22:53:48,13,0,0,0,0,0
22:53:49,13,0,0,0,0,0
22:53:50,13,0,0,0,0,0
22:53:51,13,0,0,0,0,0
22:53:52,13,0,0,0,0,0
22:53:53,13,0,0,0,0,0
22:53:54,13,0,0,0,0,0
22:53:55,13,0,0,0,0,0
22:53:56,13,0,0,0,0,0
22:53:57,13,0,0,0,0,0
22:53:58,13,0,0,0,0,0
22:53:59,13,0,0,0,0,0
22:54:00,13,0,0,0,0,0
22:54:01,13,0,0,0,0,0
22:54:02,13,0,0,0,0,0
22:54:03,13,0,0,0,0,0
22:54:04,13,0,0,0,0,0
22:54:05,13,0,0,0,0,0
22:54:06,13,0,0,0,0,0
22:54:07,13,0,0,0,0,0
22:54:08,13,0,0,0,0,0
22:54:09,13,0,0,0,0,0
22:54:10,13,0,0,0,0,0
22:54:11,13,0,0,0,0,0
22:54:12,13,0,0,0,0,0
22:54:13,13,0,0,0,0,0
22:54:14,13,0,0,0,0,0
22:54:15,13,0,0,0,0,0
22:54:16,13,0,0,0,0,0
22:54:17,13,0,0,0,0,0
22:54:18,13,0,0,0,0,0
22:54:19,13,0,0,0,0,0
22:54:20,13,0,0,0,0,0
22:54:21,13,0,0,0,0,0
22:54:22,13,0,0,0,0,0
22:54:23,13,0,0,0,0,0
22:54:24,13,0,0,0,0,0
22:54:25,13,0,0,0,0,0
22:54:26,13,0,0,0,0,0
22:54:27,13,0,0,0,0,0
22:54:28,13,0,0,0,0,0
22:54:29,13,0,0,0,0,0
22:54:30,13,0,0,0,0,0
22:54:31,13,0,0,0,0,0
22:54:32,13,0,0,0,0,0
22:54:33,13,0,0,0,0,0
22:54:34,13,0,0,0,0,0
22:54:35,13,0,0,0,0,0
22:54:36,13,0,0,0,0,0
22:54:37,13,0,0,0,0,0
22:54:38,13,0,0,0,0,0
22:54:39,13,0,0,0,0,0
22:54:40,13,0,0,0,0,0
22:54:41,13,0,0,0,0,0
22:54:42,13,0,0,0,0,0
22:54:43,13,0,0,0,0,0
22:54:44,13,0,0,0,0,0
22:54:45,13,0,0,0,0,0
22:54:46,13,0,0,0,0,0
22:54:47,13,0,0,0,0,0
22:54:48,13,0,0,0,0,0
22:54:49,13,0,0,0,0,0
22:54:50,13,0,0,0,0,0
22:54:51,13,0,0,0,0,0
22:54:52,13,0,0,0,0,0
22:54:53,13,0,0,0,0,0
22:54:54,13,0,0,0,0,0
22:54:55,13,0,0,0,0,0
22:54:56,13,0,0,0,0,0
22:54:57,13,0,0,0,0,0
22:54:58,13,0,0,0,0,0
22:54:59,13,0,0,0,0,0
22:55:00,13,0,0,0,0,0
22:55:01,13,0,0,0,0,0
22:55:02,13,0,0,0,0,0
22:55:03,13,0,0,0,0,0
22:55:04,13,0,0,0,0,0
22:55:05,13,0,0,0,0,0
22:55:06,13,0,0,0,0,0
22:55:07,13,0,0,0,0,0
22:55:08,13,0,0,0,0,0
22:55:09,13,0,0,0,0,0
22:55:10,13,0,0,0,0,0
22:55:11,13,0,0,0,0,0
22:55:12,13,0,0,0,0,0
22:55:13,13,0,0,0,0,0
22:55:14,13,0,0,0,0,0
22:55:15,13,0,0,0,0,0
22:55:16,13,0,0,0,0,0
22:55:17,13,0,0,0,0,0
22:55:18,13,0,0,0,0,0
22:55:19,13,0,0,0,0,0
22:55:20,13,0,0,0,0,0
22:55:21,13,0,0,0,0,0
22:55:22,13,0,0,0,0,0
22:55:23,13,0,0,0,0,0
22:55:24,13,0,0,0,0,0
22:55:25,13,0,0,0,0,0
22:55:26,13,0,0,0,0,0
22:55:27,13,0,0,0,0,0
22:55:28,13,0,0,0,0,0
22:55:29,13,0,0,0,0,0
22:55:30,13,0,0,0,0,0
22:55:31,13,0,0,0,0,0
22:55:32,13,0,0,0,0,0
22:55:33,13,0,0,0,0,0
22:55:34,13,0,0,0,0,0
22:55:35,13,0,0,0,0,0
22:55:36,13,0,0,0,0,0
22:55:37,13,0,0,0,0,0
22:55:38,13,0,0,0,0,0
22:55:39,13,0,0,0,0,0
22:55:40,13,0,0,0,0,0
22:55:41,13,0,0,0,0,0
22:55:42,13,0,0,0,0,0
22:55:43,13,0,0,0,0,0
22:55:44,13,0,0,0,0,0
22:55:45,13,0,0,0,0,0
22:55:46,13,0,0,0,0,0
22:55:47,13,0,0,0,0,0
22:55:48,13,0,0,0,0,0
22:55:49,13,0,0,0,0,0
22:55:50,13,0,0,0,0,0
22:55:51,13,0,0,0,0,0
22:55:52,13,0,0,0,0,0
22:55:53,13,0,0,0,0,0
22:55:54,13,0,0,0,0,0
22:55:55,13,0,0,0,0,0
22:55:56,13,0,0,0,0,0
22:55:57,13,0,0,0,0,0
22:55:58,13,0,0,0,0,0
22:55:59,13,0,0,0,0,0
22:56:00,13,0,0,0,0,0
22:56:01,13,0,0,0,0,0
22:56:02,13,0,0,0,0,0
22:56:03,13,0,0,0,0,0
22:56:04,13,0,0,0,0,0
22:56:05,13,0,0,0,0,0
22:56:06,13,0,0,0,0,0
22:56:07,13,0,0,0,0,0
22:56:08,13,0,0,0,0,0
22:56:09,13,0,0,0,0,0
22:56:10,13,0,0,0,0,0
22:56:11,13,0,0,0,0,0
22:56:12,13,0,0,0,0,0
22:56:13,13,0,0,0,0,0
22:56:14,13,0,0,0,0,0
22:56:15,13,0,0,0,0,0
22:56:16,13,0,0,0,0,0
22:56:17,13,0,0,0,0,0
22:56:18,13,0,0,0,0,0
22:56:19,13,0,0,0,0,0
22:56:20,13,0,0,0,0,0
22:56:21,13,0,0,0,0,0
22:56:22,13,0,0,0,0,0
22:56:23,13,0,0,0,0,0
22:56:24,13,0,0,0,0,0
22:56:25,13,0,0,0,0,0
22:56:26,13,0,0,0,0,0
22:56:27,13,0,0,0,0,0
22:56:28,13,0,0,0,0,0
22:56:29,13,0,0,0,0,0
22:56:30,13,0,0,0,0,0
22:56:31,13,0,0,0,0,0
22:56:32,13,0,0,0,0,0
22:56:33,13,0,0,0,0,0
22:56:34,13,0,0,0,0,0
22:56:35,13,0,0,0,0,0
22:56:36,13,0,0,0,0,0
22:56:37,13,0,0,0,0,0
22:56:38,13,0,0,0,0,0
22:56:39,13,0,0,0,0,0
22:56:40,13,0,0,0,0,0
22:56:41,13,0,0,0,0,0
22:56:42,13,0,0,0,0,0
22:56:43,13,0,0,0,0,0
22:56:44,13,0,0,0,0,0
22:56:45,13,0,0,0,0,0
22:56:46,13,0,0,0,0,0
22:56:47,13,0,0,0,0,0
22:56:48,13,0,0,0,0,0
22:56:49,13,0,0,0,0,0
22:56:50,13,0,0,0,0,0
22:56:51,13,0,0,0,0,0
22:56:52,13,0,0,0,0,0
22:56:53,13,0,0,0,0,0
22:56:54,13,0,0,0,0,0
22:56:55,13,0,0,0,0,0
22:56:56,13,0,0,0,0,0
22:56:57,13,0,0,0,0,0
22:56:58,13,0,0,0,0,0
22:56:59,13,0,0,0,0,0
22:57:00,13,0,0,0,0,0
22:57:01,13,0,0,0,0,0
22:57:02,13,0,0,0,0,0
22:57:03,13,0,0,0,0,0
22:57:04,13,0,0,0,0,0
22:57:05,13,0,0,0,0,0
22:57:06,13,0,0,0,0,0
22:57:07,13,0,0,0,0,0
22:57:08,13,0,0,0,0,0
22:57:09,13,0,0,0,0,0
22:57:10,13,0,0,0,0,0
22:57:11,13,0,0,0,0,0
22:57:12,13,0,0,0,0,0
22:57:13,13,0,0,0,0,0
22:57:14,13,0,0,0,0,0
22:57:15,13,0,0,0,0,0
22:57:16,13,0,0,0,0,0
22:57:17,13,0,0,0,0,0
22:57:18,13,0,0,0,0,0
22:57:19,13,0,0,0,0,0
22:57:20,13,0,0,0,0,0
22:57:21,13,0,0,0,0,0
22:57:22,13,0,0,0,0,0
22:57:23,13,0,0,0,0,0
22:57:24,13,0,0,0,0,0
22:57:25,13,0,0,0,0,0
22:57:26,13,0,0,0,0,0
22:57:27,13,0,0,0,0,0
22:57:28,13,0,0,0,0,0
22:57:29,13,0,0,0,0,0
22:57:30,13,0,0,0,0,0
22:57:31,13,0,0,0,0,0
22:57:32,13,0,0,0,0,0
22:57:33,13,0,0,0,0,0
22:57:34,13,0,0,0,0,0
22:57:35,13,0,0,0,0,0
22:57:36,13,0,0,0,0,0
22:57:37,13,0,0,0,0,0
22:57:38,13,0,0,0,0,0
22:57:39,13,0,0,0,0,0
22:57:40,13,0,0,0,0,0
22:57:41,13,0,0,0,0,0
22:57:42,13,0,0,0,0,0
22:57:43,13,0,0,0,0,0
22:57:44,13,0,0,0,0,0
22:57:45,13,0,0,0,0,0
22:57:46,13,0,0,0,0,0
22:57:47,13,0,0,0,0,0
22:57:48,13,0,0,0,0,0
22:57:49,13,0,0,0,0,0
22:57:50,13,0,0,0,0,0
22:57:51,13,0,0,0,0,0
22:57:52,13,0,0,0,0,0
22:57:53,13,0,0,0,0,0
22:57:54,13,0,0,0,0,0
22:57:55,13,0,0,0,0,0
22:57:56,13,0,0,0,0,0
22:57:57,13,0,0,0,0,0
22:57:58,13,0,0,0,0,0
22:57:59,13,0,0,0,0,0
22:58:00,13,0,0,0,0,0
22:58:01,13,0,0,0,0,0
22:58:02,13,0,0,0,0,0
22:58:03,13,0,0,0,0,0
22:58:04,13,0,0,0,0,0
22:58:05,13,0,0,0,0,0
22:58:06,13,0,0,0,0,0
22:58:07,13,0,0,0,0,0
22:58:08,13,0,0,0,0,0
22:58:09,13,0,0,0,0,0
22:58:10,13,0,0,0,0,0
22:58:11,13,0,0,0,0,0
22:58:12,13,0,0,0,0,0
22:58:13,13,0,0,0,0,0
22:58:14,13,0,0,0,0,0
22:58:15,13,0,0,0,0,0
22:58:16,13,0,0,0,0,0
22:58:17,13,0,0,0,0,0
22:58:18,13,0,0,0,0,0
22:58:19,13,0,0,0,0,0
22:58:20,13,0,0,0,0,0
22:58:21,13,0,0,0,0,0
22:58:22,13,0,0,0,0,0
22:58:23,13,0,0,0,0,0
22:58:24,13,0,0,0,0,0
22:58:25,13,0,0,0,0,0
22:58:26,13,0,0,0,0,0
22:58:27,13,0,0,0,0,0
22:58:28,13,0,0,0,0,0
22:58:29,13,0,0,0,0,0
22:58:30,13,0,0,0,0,0
22:58:31,13,0,0,0,0,0
22:58:32,13,0,0,0,0,0
22:58:33,13,0,0,0,0,0
22:58:34,13,0,0,0,0,0
22:58:35,13,0,0,0,0,0
22:58:36,13,0,0,0,0,0
22:58:37,13,0,0,0,0,0
22:58:38,13,0,0,0,0,0
22:58:39,13,0,0,0,0,0
22:58:40,13,0,0,0,0,0
22:58:41,13,0,0,0,0,0
22:58:42,13,0,0,0,0,0
22:58:43,13,0,0,0,0,0
22:58:44,13,0,0,0,0,0
22:58:45,13,0,0,0,0,0
22:58:46,13,0,0,0,0,0
22:58:47,13,0,0,0,0,0
22:58:48,13,0,0,0,0,0
22:58:49,13,0,0,0,0,0
22:58:50,13,0,0,0,0,0
22:58:51,13,0,0,0,0,0
22:58:52,13,0,0,0,0,0
22:58:53,13,0,0,0,0,0
22:58:54,13,0,0,0,0,0
22:58:55,13,0,0,0,0,0
22:58:56,13,0,0,0,0,0
22:58:57,13,0,0,0,0,0
22:58:58,13,0,0,0,0,0
22:58:59,13,0,0,0,0,0
22:59:00,13,0,0,0,0,0
22:59:01,13,0,0,0,0,0
22:59:02,13,0,0,0,0,0
22:59:03,13,0,0,0,0,0
22:59:04,13,0,0,0,0,0
22:59:05,13,0,0,0,0,0
22:59:06,13,0,0,0,0,0
22:59:07,13,0,0,0,0,0
22:59:08,13,0,0,0,0,0
22:59:09,13,0,0,0,0,0
22:59:10,13,0,0,0,0,0
22:59:11,13,0,0,0,0,0
22:59:12,13,0,0,0,0,0
22:59:13,13,0,0,0,0,0
22:59:14,13,0,0,0,0,0
22:59:15,13,0,0,0,0,0
22:59:16,13,0,0,0,0,0
22:59:17,13,0,0,0,0,0
22:59:18,13,0,0,0,0,0
22:59:19,13,0,0,0,0,0
22:59:20,13,0,0,0,0,0
22:59:21,13,0,0,0,0,0
22:59:22,13,0,0,0,0,0
22:59:23,13,0,0,0,0,0
22:59:24,13,0,0,0,0,0
22:59:25,13,0,0,0,0,0
22:59:26,13,0,0,0,0,0
22:59:27,13,0,0,0,0,0
22:59:28,13,0,0,0,0,0
22:59:29,13,0,0,0,0,0
22:59:30,13,0,0,0,0,0
22:59:31,13,0,0,0,0,0
22:59:32,13,0,0,0,0,0
22:59:33,13,0,0,0,0,0
22:59:34,13,0,0,0,0,0
22:59:35,13,0,0,0,0,0
22:59:36,13,0,0,0,0,0
22:59:37,13,0,0,0,0,0
22:59:38,13,0,0,0,0,0
22:59:39,13,0,0,0,0,0
22:59:40,13,0,0,0,0,0
22:59:41,13,0,0,0,0,0
22:59:42,13,0,0,0,0,0
22:59:43,13,0,0,0,0,0
22:59:44,13,0,0,0,0,0
22:59:45,13,0,0,0,0,0
22:59:46,13,0,0,0,0,0
22:59:47,13,0,0,0,0,0
22:59:48,13,0,0,0,0,0
22:59:49,13,0,0,0,0,0
22:59:50,13,0,0,0,0,0
22:59:51,13,0,0,0,0,0
22:59:52,13,0,0,0,0,0
22:59:53,13,0,0,0,0,0
22:59:54,13,0,0,0,0,0
22:59:55,13,0,0,0,0,0
22:59:56,13,0,0,0,0,0
22:59:57,13,0,0,0,0,0
22:59:58,13,0,0,0,0,0
22:59:59,13,0,0,0,0,0
23:00:00,13,0,0,0,0,0
23:00:01,13,0,0,0,0,0
23:00:02,13,0,0,0,0,0
23:00:03,13,0,0,0,0,0
23:00:04,13,0,0,0,0,0
23:00:05,13,0,0,0,0,0
23:00:06,13,0,0,0,0,0
23:00:07,13,0,0,0,0,0
23:00:08,13,0,0,0,0,0
23:00:09,13,0,0,0,0,0
23:00:10,13,0,0,0,0,0
23:00:11,13,0,0,0,0,0
23:00:12,13,0,0,0,0,0
23:00:13,13,0,0,0,0,0
23:00:14,13,0,0,0,0,0
23:00:15,13,0,0,0,0,0
23:00:16,13,0,0,0,0,0
23:00:17,13,0,0,0,0,0
23:00:18,13,0,0,0,0,0
23:00:19,13,0,0,0,0,0
23:00:20,13,0,0,0,0,0
23:00:21,13,0,0,0,0,0
23:00:22,13,0,0,0,0,0
23:00:23,13,0,0,0,0,0
23:00:24,13,0,0,0,0,0
23:00:25,13,0,0,0,0,0
23:00:26,13,0,0,0,0,0
23:00:27,13,0,0,0,0,0
23:00:28,13,0,0,0,0,0
23:00:29,13,0,0,0,0,0
23:00:30,13,0,0,0,0,0
23:00:31,13,0,0,0,0,0
23:00:32,13,0,0,0,0,0
23:00:33,13,0,0,0,0,0
23:00:34,13,0,0,0,0,0
23:00:35,13,0,0,0,0,0
23:00:36,13,0,0,0,0,0
23:00:37,13,0,0,0,0,0
23:00:38,13,0,0,0,0,0
23:00:39,13,0,0,0,0,0
23:00:40,13,0,0,0,0,0
23:00:41,13,0,0,0,0,0
23:00:42,13,0,0,0,0,0
23:00:43,13,0,0,0,0,0
23:00:44,13,0,0,0,0,0
23:00:45,13,0,0,0,0,0
23:00:46,13,0,0,0,0,0
23:00:47,13,0,0,0,0,0
23:00:48,13,0,0,0,0,0
23:00:49,13,0,0,0,0,0
23:00:50,13,0,0,0,0,0
23:00:51,13,0,0,0,0,0
23:00:52,13,0,0,0,0,0
23:00:53,13,0,0,0,0,0
23:00:54,13,0,0,0,0,0
23:00:55,13,0,0,0,0,0
23:00:56,13,0,0,0,0,0
23:00:57,13,0,0,0,0,0
23:00:58,13,0,0,0,0,0
23:00:59,13,0,0,0,0,0
23:01:00,13,0,0,0,0,0
23:01:01,13,0,0,0,0,0
23:01:02,13,0,0,0,0,0
23:01:03,13,0,0,0,0,0
23:01:04,13,0,0,0,0,0
23:01:05,13,0,0,0,0,0
23:01:06,13,0,0,0,0,0
23:01:07,13,0,0,0,0,0
23:01:08,13,0,0,0,0,0
23:01:09,13,0,0,0,0,0
23:01:10,13,0,0,0,0,0
23:01:11,13,0,0,0,0,0
23:01:12,13,0,0,0,0,0
23:01:13,13,0,0,0,0,0
23:01:14,13,0,0,0,0,0
23:01:15,13,0,0,0,0,0
23:01:16,13,0,0,0,0,0
23:01:17,13,0,0,0,0,0
23:01:18,13,0,0,0,0,0
23:01:19,13,0,0,0,0,0
23:01:20,13,0,0,0,0,0
23:01:21,13,0,0,0,0,0
23:01:22,13,0,0,0,0,0
23:01:23,13,0,0,0,0,0
23:01:24,13,0,0,0,0,0
23:01:25,13,0,0,0,0,0
23:01:26,13,0,0,0,0,0
23:01:27,13,0,0,0,0,0
23:01:28,13,0,0,0,0,0
23:01:29,13,0,0,0,0,0
23:01:30,13,0,0,0,0,0
23:01:31,13,0,0,0,0,0
23:01:32,13,0,0,0,0,0
23:01:33,13,0,0,0,0,0
23:01:34,13,0,0,0,0,0
23:01:35,13,0,0,0,0,0
23:01:36,13,0,0,0,0,0
23:01:37,13,0,0,0,0,0
23:01:38,13,0,0,0,0,0
23:01:39,13,0,0,0,0,0
23:01:40,13,0,0,0,0,0
23:01:41,13,0,0,0,0,0
23:01:42,13,0,0,0,0,0
23:01:43,13,0,0,0,0,0
23:01:44,13,0,0,0,0,0
23:01:45,13,0,0,0,0,0
23:01:46,13,0,0,0,0,0
23:01:47,13,0,0,0,0,0
23:01:48,13,0,0,0,0,0
23:01:49,13,0,0,0,0,0
23:01:50,13,0,0,0,0,0
23:01:51,13,0,0,0,0,0
23:01:52,13,0,0,0,0,0
23:01:53,13,0,0,0,0,0
23:01:54,13,0,0,0,0,0
23:01:55,13,0,0,0,0,0
23:01:56,13,0,0,0,0,0
23:01:57,13,0,0,0,0,0
23:01:58,13,0,0,0,0,0
23:01:59,13,0,0,0,0,0
23:02:00,13,0,0,0,0,0
23:02:01,13,0,0,0,0,0
23:02:02,13,0,0,0,0,0
23:02:03,13,0,0,0,0,0
23:02:04,13,0,0,0,0,0
23:02:05,13,0,0,0,0,0
23:02:06,13,0,0,0,0,0
23:02:07,13,0,0,0,0,0
23:02:08,13,0,0,0,0,0
23:02:09,13,0,0,0,0,0
23:02:10,13,0,0,0,0,0
23:02:11,13,0,0,0,0,0
23:02:12,13,0,0,0,0,0
23:02:13,13,0,0,0,0,0
23:02:14,13,0,0,0,0,0
23:02:15,13,0,0,0,0,0
23:02:16,13,0,0,0,0,0
23:02:17,13,0,0,0,0,0
23:02:18,13,0,0,0,0,0
23:02:19,13,0,0,0,0,0
23:02:20,13,0,0,0,0,0
23:02:21,13,0,0,0,0,0
23:02:22,13,0,0,0,0,0
23:02:23,13,0,0,0,0,0
23:02:24,13,0,0,0,0,0
23:02:25,13,0,0,0,0,0
23:02:26,13,0,0,0,0,0
23:02:27,13,0,0,0,0,0
23:02:28,13,0,0,0,0,0
23:02:29,13,0,0,0,0,0
23:02:30,13,0,0,0,0,0
23:02:31,13,0,0,0,0,0
23:02:32,13,0,0,0,0,0
23:02:33,13,0,0,0,0,0
23:02:34,13,0,0,0,0,0
23:02:35,13,0,0,0,0,0
23:02:36,13,0,0,0,0,0
23:02:37,13,0,0,0,0,0
23:02:38,13,0,0,0,0,0
23:02:39,13,0,0,0,0,0
23:02:40,13,0,0,0,0,0
23:02:41,13,0,0,0,0,0
23:02:42,13,0,0,0,0,0
23:02:43,13,0,0,0,0,0
23:02:44,13,0,0,0,0,0
23:02:45,13,0,0,0,0,0
23:02:46,13,0,0,0,0,0
23:02:47,13,0,0,0,0,0
23:02:48,13,0,0,0,0,0
23:02:49,13,0,0,0,0,0
23:02:50,13,0,0,0,0,0
23:02:51,13,0,0,0,0,0
23:02:52,13,0,0,0,0,0
23:02:53,13,0,0,0,0,0
23:02:54,13,0,0,0,0,0
23:02:55,13,0,0,0,0,0
23:02:56,13,0,0,0,0,0
23:02:57,13,0,0,0,0,0
23:02:58,13,0,0,0,0,0
23:02:59,13,0,0,0,0,0
23:03:00,13,0,0,0,0,0
23:03:01,13,0,0,0,0,0
23:03:02,13,0,0,0,0,0
23:03:03,13,0,0,0,0,0
23:03:04,13,0,0,0,0,0
23:03:05,13,0,0,0,0,0
23:03:06,13,0,0,0,0,0
23:03:07,13,0,0,0,0,0
23:03:08,13,0,0,0,0,0
23:03:09,13,0,0,0,0,0
23:03:10,13,0,0,0,0,0
23:03:11,13,0,0,0,0,0
23:03:12,13,0,0,0,0,0
23:03:13,13,0,0,0,0,0
23:03:14,13,0,0,0,0,0
23:03:15,13,0,0,0,0,0
23:03:16,13,0,0,0,0,0
23:03:17,13,0,0,0,0,0
23:03:18,13,0,0,0,0,0
23:03:19,13,0,0,0,0,0
23:03:20,13,0,0,0,0,0
23:03:21,13,0,0,0,0,0
23:03:22,13,0,0,0,0,0
23:03:23,13,0,0,0,0,0
23:03:24,13,0,0,0,0,0
23:03:25,13,0,0,0,0,0
23:03:26,13,0,0,0,0,0
23:03:27,13,0,0,0,0,0
23:03:28,13,0,0,0,0,0
23:03:29,13,0,0,0,0,0
23:03:30,13,0,0,0,0,0
23:03:31,13,0,0,0,0,0
23:03:32,13,0,0,0,0,0
23:03:33,13,0,0,0,0,0
23:03:34,13,0,0,0,0,0
23:03:35,13,0,0,0,0,0
23:03:36,13,0,0,0,0,0
23:03:37,13,0,0,0,0,0
23:03:38,13,0,0,0,0,0
23:03:39,13,0,0,0,0,0
23:03:40,13,0,0,0,0,0
23:03:41,13,0,0,0,0,0
23:03:42,13,0,0,0,0,0
23:03:43,13,0,0,0,0,0
23:03:44,13,0,0,0,0,0
23:03:45,13,0,0,0,0,0
23:03:46,13,0,0,0,0,0
23:03:47,13,0,0,0,0,0
23:03:48,13,0,0,0,0,0
23:03:49,13,0,0,0,0,0
23:03:50,13,0,0,0,0,0
23:03:51,13,0,0,0,0,0
23:03:52,13,0,0,0,0,0
23:03:53,13,0,0,0,0,0
23:03:54,13,0,0,0,0,0
23:03:55,13,0,0,0,0,0
23:03:56,13,0,0,0,0,0
23:03:57,13,0,0,0,0,0
23:03:58,13,0,0,0,0,0
23:03:59,13,0,0,0,0,0
23:04:00,13,0,0,0,0,0
23:04:01,13,0,0,0,0,0
23:04:02,13,0,0,0,0,0
23:04:03,13,0,0,0,0,0
23:04:04,13,0,0,0,0,0
23:04:05,13,0,0,0,0,0
23:04:06,13,0,0,0,0,0
23:04:07,13,0,0,0,0,0
23:04:08,13,0,0,0,0,0
23:04:09,13,0,0,0,0,0
23:04:10,13,0,0,0,0,0
23:04:11,13,0,0,0,0,0
23:04:12,13,0,0,0,0,0
23:04:13,13,0,0,0,0,0
23:04:14,13,0,0,0,0,0
23:04:15,13,0,0,0,0,0
23:04:16,13,0,0,0,0,0
23:04:17,13,0,0,0,0,0
23:04:18,13,0,0,0,0,0
23:04:19,13,0,0,0,0,0
23:04:20,13,0,0,0,0,0
23:04:21,13,0,0,0,0,0
23:04:22,13,0,0,0,0,0
23:04:23,13,0,0,0,0,0
23:04:24,13,0,0,0,0,0
23:04:25,13,0,0,0,0,0
23:04:26,13,0,0,0,0,0
23:04:27,13,0,0,0,0,0
23:04:28,13,0,0,0,0,0
23:04:29,13,0,0,0,0,0
23:04:30,13,0,0,0,0,0
23:04:31,13,0,0,0,0,0
23:04:32,13,0,0,0,0,0
23:04:33,13,0,0,0,0,0
23:04:34,13,0,0,0,0,0
23:04:35,13,0,0,0,0,0
23:04:36,13,0,0,0,0,0
23:04:37,13,0,0,0,0,0
23:04:38,13,0,0,0,0,0
23:04:39,13,0,0,0,0,0
23:04:40,13,0,0,0,0,0
23:04:41,13,0,0,0,0,0
23:04:42,13,0,0,0,0,0
23:04:43,13,0,0,0,0,0
23:04:44,13,0,0,0,0,0
23:04:45,13,0,0,0,0,0
23:04:46,13,0,0,0,0,0
23:04:47,13,0,0,0,0,0
23:04:48,13,0,0,0,0,0
23:04:49,13,0,0,0,0,0
23:04:50,13,0,0,0,0,0
23:04:51,13,0,0,0,0,0
23:04:52,13,0,0,0,0,0
23:04:53,13,0,0,0,0,0
23:04:54,13,0,0,0,0,0
23:04:55,13,0,0,0,0,0
23:04:56,13,0,0,0,0,0
23:04:57,13,0,0,0,0,0
23:04:58,13,0,0,0,0,0
23:04:59,13,0,0,0,0,0
23:05:00,13,0,0,0,0,0
23:05:01,13,0,0,0,0,0
23:05:02,13,0,0,0,0,0
23:05:03,13,0,0,0,0,0
23:05:04,13,0,0,0,0,0
23:05:05,13,0,0,0,0,0
23:05:06,13,0,0,0,0,0
23:05:07,13,0,0,0,0,0
23:05:08,13,0,0,0,0,0
23:05:09,13,0,0,0,0,0
23:05:10,13,0,0,0,0,0
23:05:11,13,0,0,0,0,0
23:05:12,13,0,0,0,0,0
23:05:13,13,0,0,0,0,0
23:05:14,13,0,0,0,0,0
23:05:15,13,0,0,0,0,0
23:05:16,13,0,0,0,0,0
23:05:17,13,0,0,0,0,0
23:05:18,13,0,0,0,0,0
23:05:19,13,0,0,0,0,0
23:05:20,13,0,0,0,0,0
23:05:21,13,0,0,0,0,0
23:05:22,13,0,0,0,0,0
23:05:23,13,0,0,0,0,0
23:05:24,13,0,0,0,0,0
23:05:25,13,0,0,0,0,0
23:05:26,13,0,0,0,0,0
23:05:27,13,0,0,0,0,0
23:05:28,13,0,0,0,0,0
23:05:29,13,0,0,0,0,0
23:05:30,13,0,0,0,0,0
23:05:31,13,0,0,0,0,0
23:05:32,13,0,0,0,0,0
23:05:33,13,0,0,0,0,0
23:05:34,13,0,0,0,0,0
23:05:35,13,0,0,0,0,0
23:05:36,13,0,0,0,0,0
23:05:37,13,0,0,0,0,0
23:05:38,13,0,0,0,0,0
23:05:39,13,0,0,0,0,0
23:05:40,13,0,0,0,0,0
23:05:41,13,0,0,0,0,0
23:05:42,13,0,0,0,0,0
23:05:43,13,0,0,0,0,0
23:05:44,13,0,0,0,0,0
23:05:45,13,0,0,0,0,0
23:05:46,13,0,0,0,0,0
23:05:47,13,0,0,0,0,0
23:05:48,13,0,0,0,0,0
23:05:49,13,0,0,0,0,0
23:05:50,13,0,0,0,0,0
23:05:51,13,0,0,0,0,0
23:05:52,13,0,0,0,0,0
23:05:53,13,0,0,0,0,0
23:05:54,13,0,0,0,0,0
23:05:55,13,0,0,0,0,0
23:05:56,13,0,0,0,0,0
23:05:57,13,0,0,0,0,0
23:05:58,13,0,0,0,0,0
23:05:59,13,0,0,0,0,0
23:06:00,13,0,0,0,0,0
23:06:01,13,0,0,0,0,0
23:06:02,13,0,0,0,0,0
23:06:03,13,0,0,0,0,0
23:06:04,13,0,0,0,0,0
23:06:05,13,0,0,0,0,0
23:06:06,13,0,0,0,0,0
23:06:07,13,0,0,0,0,0
23:06:08,13,0,0,0,0,0
23:06:09,13,0,0,0,0,0
23:06:10,13,0,0,0,0,0
23:06:11,13,0,0,0,0,0
23:06:12,13,0,0,0,0,0
23:06:13,13,0,0,0,0,0
23:06:14,13,0,0,0,0,0
23:06:15,13,0,0,0,0,0
23:06:16,13,0,0,0,0,0
23:06:17,13,0,0,0,0,0
23:06:18,13,0,0,0,0,0
23:06:19,13,0,0,0,0,0
23:06:20,13,0,0,0,0,0
23:06:21,13,0,0,0,0,0
23:06:22,13,0,0,0,0,0
23:06:23,13,0,0,0,0,0
23:06:24,13,0,0,0,0,0
23:06:25,13,0,0,0,0,0
23:06:26,13,0,0,0,0,0
23:06:27,13,0,0,0,0,0
23:06:28,13,0,0,0,0,0
23:06:29,13,0,0,0,0,0
23:06:30,13,0,0,0,0,0
23:06:31,13,0,0,0,0,0
23:06:32,13,0,0,0,0,0
23:06:33,13,0,0,0,0,0
23:06:34,13,0,0,0,0,0
23:06:35,13,0,0,0,0,0
23:06:36,13,0,0,0,0,0
23:06:37,13,0,0,0,0,0
23:06:38,13,0,0,0,0,0
23:06:39,13,0,0,0,0,0
23:06:40,13,0,0,0,0,0
23:06:41,13,0,0,0,0,0
23:06:42,13,0,0,0,0,0
23:06:43,13,0,0,0,0,0
23:06:44,13,0,0,0,0,0
23:06:45,13,0,0,0,0,0
23:06:46,13,0,0,0,0,0
23:06:47,13,0,0,0,0,0
23:06:48,13,0,0,0,0,0
23:06:49,13,0,0,0,0,0
23:06:50,13,0,0,0,0,0
23:06:51,13,0,0,0,0,0
23:06:52,13,0,0,0,0,0
23:06:53,13,0,0,0,0,0
23:06:54,13,0,0,0,0,0
23:06:55,13,0,0,0,0,0
23:06:56,13,0,0,0,0,0
23:06:57,13,0,0,0,0,0
23:06:58,13,0,0,0,0,0
23:06:59,13,0,0,0,0,0
23:07:00,13,0,0,0,0,0
23:07:01,13,0,0,0,0,0
23:07:02,13,0,0,0,0,0
23:07:03,13,0,0,0,0,0
23:07:04,13,0,0,0,0,0
23:07:05,13,0,0,0,0,0
22:50:41,14,0,0,0,0,0
22:50:42,14,1002,488,547,0,2037
22:50:43,14,0,0,0,0,0
22:50:44,14,0,0,0,0,0
22:50:45,14,0,0,0,0,0
22:50:46,14,0,0,0,0,0
22:50:47,14,0,0,0,0,0
22:50:48,14,1001,488,547,0,2036
22:50:49,14,0,0,0,0,0
22:50:50,14,0,0,0,0,0
22:50:51,14,0,0,0,0,0
22:50:52,14,1001,484,547,0,2032
22:50:53,14,0,0,0,0,0
22:50:54,14,0,0,0,0,0
22:50:55,14,0,0,0,0,0
22:50:56,14,0,0,0,0,0
22:50:57,14,1002,499,547,0,2048
22:50:58,14,0,0,0,0,0
22:50:59,14,0,0,0,0,0
22:51:00,14,0,0,0,0,0
22:51:01,14,0,0,0,0,0
22:51:02,14,1001,505,547,0,2053
22:51:03,14,0,0,0,0,0
22:51:04,14,0,0,0,0,0
22:51:05,14,0,0,0,0,0
22:51:06,14,0,0,0,0,0
22:51:07,14,0,0,0,0,0
22:51:08,14,0,0,0,0,0
22:51:09,14,0,0,0,0,0
22:51:10,14,0,0,0,0,0
22:51:11,14,0,0,0,0,0
22:51:12,14,0,0,0,0,0
22:51:13,14,0,0,0,0,0
22:51:14,14,1002,460,546,0,2008
22:51:15,14,1002,503,546,0,2051
22:51:16,14,1002,492,546,0,2040
22:51:17,14,1002,500,546,0,2048
22:51:18,14,1002,488,546,0,2036
22:51:19,14,1001,493,546,0,2040
22:51:20,14,1002,507,546,0,2055
22:51:21,14,1001,484,546,0,2031
22:51:22,14,1002,484,546,0,2032
22:51:23,14,1001,494,546,0,2041
22:51:24,14,1001,480,546,0,2027
22:51:25,14,1001,543,547,0,2091
22:51:26,14,1002,485,547,0,2034
22:51:27,14,1002,511,547,0,2060
22:51:28,14,0,0,0,0,0
22:51:29,14,1002,492,546,0,2040
22:51:30,14,0,0,0,0,0
22:51:31,14,0,0,0,0,0
22:51:32,14,1002,490,546,0,2038
22:51:33,14,0,0,0,0,0
22:51:34,14,0,0,0,0,0
22:51:35,14,1001,491,546,0,2038
22:51:36,14,0,0,0,0,0
22:51:37,14,0,0,0,0,0
22:51:38,14,0,0,0,0,0
22:51:39,14,0,0,0,0,0
22:51:40,14,1002,495,547,108,2152
22:51:41,14,0,0,0,0,0
22:51:42,14,0,0,0,0,0
22:51:43,14,0,0,0,0,0
22:51:44,14,0,0,0,0,0
22:51:45,14,0,0,0,0,0
22:51:46,14,1002,475,546,423,2446
22:51:47,14,1001,484,546,629,2660
22:51:48,14,0,0,0,0,0
22:51:49,14,0,0,0,0,0
22:51:50,14,0,0,0,0,0
22:51:51,14,0,0,0,0,0
22:51:52,14,0,0,0,0,0
22:51:53,14,1001,500,546,600,2647
22:51:54,14,1001,492,546,537,2576
22:51:55,14,1001,486,546,327,2360
22:51:56,14,1001,485,546,608,2640
22:51:57,14,0,0,0,0,0
22:51:58,14,1002,480,547,631,2660
22:51:59,14,1002,482,551,350,2385
22:52:00,14,1005,469,557,586,2617
22:52:01,14,1003,464,561,572,2600
22:52:02,14,0,0,0,0,0
22:52:03,14,1003,505,567,599,2674
22:52:04,14,1002,514,569,503,2588
22:52:05,14,1002,481,570,525,2578
22:52:06,14,1001,474,571,459,2505
22:52:07,14,1002,427,571,459,2459
22:52:08,14,1001,489,572,381,2443
22:52:09,14,1001,626,575,659,2861
22:52:10,14,0,0,0,0,0
22:52:11,14,0,0,0,0,0
22:52:12,14,1003,426,587,599,2615
22:52:13,14,1001,459,588,595,2643
22:52:14,14,1001,473,589,399,2462
22:52:15,14,0,0,0,0,0
22:52:16,14,1001,508,593,466,2568
22:52:17,14,1002,502,596,427,2527
22:52:18,14,1001,466,598,487,2552
22:52:19,14,1002,499,602,499,2602
22:52:20,14,1001,494,606,480,2581
22:52:21,14,1001,482,608,384,2475
22:52:22,14,1004,591,619,328,2542
22:52:23,14,1003,534,623,563,2723
22:52:24,14,1003,522,631,747,2903
22:52:25,14,1004,497,635,327,2463
22:52:26,14,0,0,0,0,0
22:52:27,14,1002,493,647,527,2669
22:52:28,14,1002,493,647,672,2814
22:52:29,14,1000,454,727,654,2835
22:52:30,14,891,453,709,283,2336
22:52:31,14,889,464,702,577,2632
22:52:32,14,880,471,700,679,2730
22:52:33,14,879,509,699,886,2973
22:52:34,14,881,453,698,973,3005
22:52:35,14,879,430,698,869,2876
22:52:36,14,888,476,697,803,2864
22:52:37,14,890,494,697,890,2971
22:52:38,14,885,478,696,842,2901
22:52:39,14,884,503,696,970,3053
22:52:40,14,885,496,695,858,2934
22:52:41,14,0,0,0,0,0
22:52:42,14,889,496,693,914,2992
22:52:43,14,0,0,0,0,0
22:52:44,14,887,482,693,875,2937
22:52:45,14,888,495,692,884,2959
22:52:46,14,903,490,692,840,2925
22:52:47,14,902,495,691,892,2980
22:52:48,14,905,489,691,843,2928
22:52:49,14,904,495,691,868,2958
22:52:50,14,0,0,0,0,0
22:52:51,14,0,0,0,0,0
22:52:52,14,909,482,692,960,3043
22:52:53,14,907,476,691,753,2827
22:52:54,14,905,495,689,856,2945
22:52:55,14,0,0,0,0,0
22:52:56,14,0,0,0,0,0
22:52:57,14,905,497,689,940,3031
22:52:58,14,905,480,688,922,2995
22:52:59,14,0,0,0,0,0
22:53:00,14,0,0,0,0,0
22:53:01,14,0,0,0,0,0
22:53:02,14,0,0,0,0,0
22:53:03,14,0,0,0,0,0
22:53:04,14,907,498,688,824,2917
22:53:05,14,907,493,686,995,3081
22:53:06,14,906,488,684,855,2933
22:53:07,14,906,488,684,864,2942
22:53:08,14,907,492,684,889,2972
22:53:09,14,0,0,0,0,0
22:53:10,14,909,485,683,835,2912
22:53:11,14,909,477,682,971,3039
22:53:12,14,914,491,681,908,2994
22:53:13,14,914,488,681,871,2954
22:53:14,14,915,484,681,838,2918
22:53:15,14,914,490,680,872,2956
22:53:16,14,913,494,680,903,2990
22:53:17,14,912,496,679,871,2958
22:53:18,14,909,493,677,836,2915
22:53:19,14,909,487,677,888,2961
22:53:20,14,909,468,676,866,2919
22:53:21,14,912,485,676,888,2961
22:53:22,14,913,486,675,965,3039
22:53:23,14,911,484,676,944,3015
22:53:24,14,909,505,676,891,2981
22:53:25,14,905,502,675,868,2950
22:53:26,14,906,486,675,914,2981
22:53:27,14,910,485,675,835,2905
22:53:28,14,908,504,675,865,2952
22:53:29,14,908,502,674,945,3029
22:53:30,14,909,497,674,876,2956
22:53:31,14,909,469,673,923,2974
22:53:32,14,909,494,672,773,2848
22:53:33,14,910,500,671,908,2989
22:53:34,14,913,490,671,877,2951
22:53:35,14,913,491,671,897,2972
22:53:36,14,912,489,671,879,2951
22:53:37,14,911,496,670,892,2969
22:53:38,14,911,490,669,871,2941
22:53:39,14,908,490,669,884,2951
22:53:40,14,907,490,669,889,2955
22:53:41,14,907,488,667,858,2920
22:53:42,14,908,488,666,856,2918
22:53:43,14,907,492,665,866,2930
22:53:44,14,907,490,664,856,2917
22:53:45,14,907,495,662,869,2933
22:53:46,14,907,493,661,877,2938
22:53:47,14,909,492,661,836,2898
22:53:48,14,907,493,661,897,2958
22:53:49,14,907,489,661,871,2928
22:53:50,14,907,486,661,873,2927
22:53:51,14,906,490,661,885,2942
22:53:52,14,907,481,661,855,2904
22:53:53,14,908,491,661,878,2938
22:53:54,14,911,492,661,856,2920
22:53:55,14,909,489,660,877,2935
22:53:56,14,910,492,659,874,2935
22:53:57,14,910,488,658,892,2948
22:53:58,14,910,488,658,891,2947
22:53:59,14,909,494,658,877,2938
22:54:00,14,909,487,658,910,2964
22:54:01,14,909,489,658,875,2931
22:54:02,14,909,485,657,857,2908
22:54:03,14,908,488,657,887,2940
22:54:04,14,908,490,657,866,2921
22:54:05,14,908,493,657,869,2927
22:54:06,14,907,490,656,874,2927
22:54:07,14,908,491,656,883,2938
22:54:08,14,908,491,656,887,2942
22:54:09,14,908,489,656,889,2942
22:54:10,14,908,491,655,897,2951
22:54:11,14,908,489,655,872,2924
22:54:12,14,908,489,655,902,2954
22:54:13,14,909,488,654,889,2940
22:54:14,14,913,482,654,887,2936
22:54:15,14,918,490,654,893,2955
22:54:16,14,918,485,654,878,2935
22:54:17,14,918,489,654,897,2958
22:54:18,14,915,487,653,898,2953
22:54:19,14,915,490,653,931,2989
22:54:20,14,914,489,653,848,2904
22:54:21,14,914,499,653,971,3037
22:54:22,14,911,488,653,876,2928
22:54:23,14,915,488,652,899,2954
22:54:24,14,909,521,652,824,2906
22:54:25,14,900,482,651,861,2894
22:54:26,14,946,496,651,897,2990
22:54:27,14,987,503,650,864,3004
22:54:28,14,1000,493,649,887,3029
22:54:29,14,1000,496,648,883,3027
22:54:30,14,1000,493,648,845,2986
22:54:31,14,1000,493,647,903,3043
22:54:32,14,1000,489,646,835,2970
22:54:33,14,1000,491,646,853,2990
22:54:34,14,1001,486,644,941,3072
22:54:35,14,1001,488,644,931,3064
22:54:36,14,1001,496,643,856,2996
22:54:37,14,1000,496,643,895,3034
22:54:38,14,1000,511,642,904,3057
22:54:39,14,1001,487,643,901,3032
22:54:40,14,1001,494,644,920,3059
22:54:41,14,1001,492,643,865,3001
22:54:42,14,1000,495,643,897,3035
22:54:43,14,1001,438,642,853,2934
22:54:44,14,1000,498,641,864,3003
22:54:45,14,1001,492,639,886,3018
22:54:46,14,1000,491,639,861,2991
22:54:47,14,1000,490,638,797,2925
22:54:48,14,1001,491,637,814,2943
22:54:49,14,1001,499,636,902,3038
22:54:50,14,1001,493,636,885,3015
22:54:51,14,1001,493,636,923,3053
22:54:52,14,1001,494,636,862,2993
22:54:53,14,1001,489,636,827,2953
22:54:54,14,1001,492,634,861,2988
22:54:55,14,1001,486,634,867,2988
22:54:56,14,1001,497,633,927,3058
22:54:57,14,1001,495,632,900,3028
22:54:58,14,1001,489,632,846,2968
22:54:59,14,1001,488,632,929,3050
22:55:00,14,1001,495,631,886,3013
22:55:01,14,1001,490,632,887,3010
22:55:02,14,1001,494,632,819,2946
22:55:03,14,1001,493,632,842,2968
22:55:04,14,1001,502,632,922,3057
22:55:05,14,1002,496,633,954,3085
22:55:06,14,1001,482,633,860,2976
22:55:07,14,1001,492,633,827,2953
22:55:08,14,1001,487,633,850,2971
22:55:09,14,1001,492,633,894,3020
22:55:10,14,1002,485,633,976,3096
22:55:11,14,1001,498,633,824,2956
22:55:12,14,1001,499,634,942,3076
22:55:13,14,1001,500,634,902,3037
22:55:14,14,1001,511,636,888,3036
22:55:15,14,1001,496,638,890,3025
22:55:16,14,1001,494,643,903,3041
22:55:17,14,1003,496,648,870,3017
22:55:18,14,1001,486,650,831,2968
22:55:19,14,1001,509,649,866,3025
22:55:20,14,1001,478,648,850,2977
22:55:21,14,1001,509,647,882,3039
22:55:22,14,1001,486,647,912,3046
22:55:23,14,1000,504,645,846,2995
22:55:24,14,1000,486,643,858,2987
22:55:25,14,1000,505,643,832,2980
22:55:26,14,1000,498,642,849,2989
22:55:27,14,1001,483,640,919,3043
22:55:28,14,1002,491,639,878,3010
22:55:29,14,1001,491,637,864,2993
22:55:30,14,1001,483,636,853,2973
22:55:31,14,1001,492,636,796,2925
22:55:32,14,1001,500,637,909,3047
22:55:33,14,1000,492,636,911,3039
22:55:34,14,1001,485,636,810,2932
22:55:35,14,1000,497,634,812,2943
22:55:36,14,1001,496,634,931,3062
22:55:37,14,1000,485,633,906,3024
22:55:38,14,1001,494,632,842,2969
22:55:39,14,1001,471,632,804,2908
22:55:40,14,1001,493,631,932,3057
22:55:41,14,1001,498,631,853,2983
22:55:42,14,1001,493,630,888,3012
22:55:43,14,1001,485,630,783,2899
22:55:44,14,1001,494,629,940,3064
22:55:45,14,1001,496,629,856,2982
22:55:46,14,1000,496,629,875,3000
22:55:47,14,1001,492,628,872,2993
22:55:48,14,1000,495,627,948,3070
22:55:49,14,1001,490,627,892,3010
22:55:50,14,1001,483,627,837,2948
22:55:51,14,1002,499,627,920,3048
22:55:52,14,1001,476,627,796,2900
22:55:53,14,1001,501,627,855,2984
22:55:54,14,1000,494,627,898,3019
22:55:55,14,1001,489,626,897,3013
22:55:56,14,1001,483,627,941,3052
22:55:57,14,1001,484,628,868,2981
22:55:58,14,1001,496,628,891,3016
22:55:59,14,1001,494,628,844,2967
22:56:00,14,1000,505,627,895,3027
22:56:01,14,1001,485,627,947,3060
22:56:02,14,1002,488,627,925,3042
22:56:03,14,1001,501,627,874,3003
22:56:04,14,1001,484,626,859,2970
22:56:05,14,1001,477,625,857,2960
22:56:06,14,1001,498,625,797,2921
22:56:07,14,1001,509,624,853,2987
22:56:08,14,1001,484,624,833,2942
22:56:09,14,1001,485,624,865,2975
22:56:10,14,1001,504,623,845,2973
22:56:11,14,1001,493,623,798,2915
22:56:12,14,1000,494,622,901,3017
22:56:13,14,1001,483,623,944,3051
22:56:14,14,1001,483,622,799,2905
22:56:15,14,1000,501,621,937,3059
22:56:16,14,1000,505,621,753,2879
22:56:17,14,1001,505,620,860,2986
22:56:18,14,1001,481,620,511,2613
22:56:19,14,1001,504,620,686,2811
22:56:20,14,1000,493,620,576,2689
22:56:21,14,1001,497,620,469,2587
22:56:22,14,1001,493,619,492,2605
22:56:23,14,1001,499,620,567,2687
22:56:24,14,1000,491,619,554,2664
22:56:25,14,1001,494,619,649,2763
22:56:26,14,1001,492,619,545,2657
22:56:27,14,1001,485,620,531,2637
22:56:28,14,1001,491,619,712,2823
22:56:29,14,1001,490,620,455,2566
22:56:30,14,1001,486,620,497,2604
22:56:31,14,1001,492,620,428,2541
22:56:32,14,1001,505,620,464,2590
22:56:33,14,1001,499,620,702,2822
22:56:34,14,1001,495,620,663,2779
22:56:35,14,1001,493,619,494,2607
22:56:36,14,1001,493,620,553,2667
22:56:37,14,1001,496,624,349,2470
22:56:38,14,1001,490,632,503,2626
22:56:39,14,1001,479,632,648,2760
22:56:40,14,1001,501,634,522,2658
22:56:41,14,1001,491,634,699,2825
22:56:42,14,1002,497,636,419,2554
22:56:43,14,1001,495,640,541,2677
22:56:44,14,1001,512,641,476,2630
22:56:45,14,1000,475,640,518,2633
22:56:46,14,1001,494,640,544,2679
22:56:47,14,1001,492,640,435,2568
22:56:48,14,1001,481,640,473,2595
22:56:49,14,1001,485,638,503,2627
22:56:50,14,1001,484,638,576,2699
22:56:51,14,1001,494,638,651,2784
22:56:52,14,1001,482,637,601,2721
22:56:53,14,1001,493,637,585,2716
22:56:54,14,1001,494,637,267,2399
22:56:55,14,1001,497,637,517,2652
22:56:56,14,1000,502,637,546,2685
22:56:57,14,1000,495,636,442,2573
22:56:58,14,1001,496,637,474,2608
22:56:59,14,1000,497,636,968,3101
22:57:00,14,1001,494,637,923,3055
22:57:01,14,1000,487,642,915,3044
22:57:02,14,1000,495,642,844,2981
22:57:03,14,1000,495,641,922,3058
22:57:04,14,0,0,0,0,0
22:57:05,14,1001,497,642,897,3037
22:57:06,14,1001,484,643,896,3024
22:57:07,14,1000,488,642,922,3052
22:57:08,14,1000,488,642,956,3086
22:57:09,14,1000,486,642,827,2955
22:57:10,14,1000,483,642,922,3047
22:57:11,14,1000,498,642,833,2973
22:57:12,14,1000,494,641,903,3038
22:57:13,14,1000,496,641,910,3047
22:57:14,14,1000,485,640,838,2963
22:57:15,14,1000,488,640,886,3014
22:57:16,14,1000,486,639,889,3014
22:57:17,14,1000,481,639,898,3018
22:57:18,14,1000,504,639,901,3044
22:57:19,14,1000,504,637,857,2998
22:57:20,14,1000,487,636,590,2713
22:57:21,14,1000,476,636,624,2736
22:57:22,14,1001,490,634,749,2874
22:57:23,14,1000,495,634,505,2634
22:57:24,14,1000,492,634,663,2789
22:57:25,14,1001,491,633,435,2560
22:57:26,14,1000,485,632,594,2711
22:57:27,14,1001,496,633,518,2648
22:57:28,14,1001,486,635,471,2593
22:57:29,14,1000,504,638,547,2689
22:57:30,14,1000,488,641,557,2686
22:57:31,14,1000,493,643,469,2605
22:57:32,14,1000,497,643,519,2659
22:57:33,14,1001,481,645,351,2478
22:57:34,14,1000,481,647,415,2543
22:57:35,14,1000,492,647,406,2545
22:57:36,14,1000,506,647,466,2619
22:57:37,14,1000,491,648,275,2414
22:57:38,14,1001,519,648,511,2679
22:57:39,14,1001,500,648,463,2612
22:57:40,14,1001,490,647,483,2621
22:57:41,14,1001,502,647,614,2764
22:57:42,14,1001,472,643,547,2663
22:57:43,14,1000,486,643,634,2763
22:57:44,14,1001,477,642,587,2707
22:57:45,14,1001,492,641,349,2483
22:57:46,14,1001,485,640,302,2428
22:57:47,14,1000,498,639,460,2597
22:57:48,14,1001,494,639,592,2726
22:57:49,14,1001,495,638,475,2609
22:57:50,14,1001,496,638,629,2764
22:57:51,14,1000,497,638,586,2721
22:57:52,14,1001,500,637,623,2761
22:57:53,14,1001,490,637,550,2678
22:57:54,14,1001,512,639,476,2628
22:57:55,14,1001,490,647,665,2803
22:57:56,14,1000,497,651,473,2621
22:57:57,14,1000,496,658,546,2700
22:57:58,14,1000,494,661,263,2418
22:57:59,14,1000,489,665,505,2659
22:58:00,14,1000,503,669,587,2759
22:58:01,14,1001,501,672,452,2626
22:58:02,14,1000,497,676,937,3110
22:58:03,14,1000,495,677,933,3105
22:58:04,14,1000,494,676,880,3050
22:58:05,14,1000,501,674,945,3120
22:58:06,14,0,0,0,0,0
22:58:07,14,1000,494,673,966,3133
22:58:08,14,1000,492,672,877,3041
22:58:09,14,1001,474,670,977,3122
22:58:10,14,1000,494,671,903,3068
22:58:11,14,1000,500,670,883,3053
22:58:12,14,1001,502,670,856,3029
22:58:13,14,1000,490,669,858,3017
22:58:14,14,1001,486,668,925,3080
22:58:15,14,1000,482,668,887,3037
22:58:16,14,1000,485,667,867,3019
22:58:17,14,1000,492,667,940,3099
22:58:18,14,1000,493,665,884,3042
22:58:19,14,1000,486,664,898,3048
22:58:20,14,1000,494,662,966,3122
22:58:21,14,1000,499,657,934,3090
22:58:22,14,1001,492,657,826,2976
22:58:23,14,1000,482,655,850,2987
22:58:24,14,1001,499,654,893,3047
22:58:25,14,1000,495,655,854,3004
22:58:26,14,1000,490,654,880,3024
22:58:27,14,1001,498,655,864,3018
22:58:28,14,1001,502,654,937,3094
22:58:29,14,1000,500,655,933,3088
22:58:30,14,1000,501,654,897,3052
22:58:31,14,1000,488,653,826,2967
22:58:32,14,1000,496,653,914,3063
22:58:33,14,1000,501,652,876,3029
22:58:34,14,1000,512,653,852,3017
22:58:35,14,1001,487,653,471,2612
22:58:36,14,1000,494,653,579,2726
22:58:37,14,1000,489,654,503,2646
22:58:38,14,1000,429,655,648,2732
22:58:39,14,1000,492,656,661,2809
22:58:40,14,1000,496,656,435,2587
22:58:41,14,1001,489,655,284,2429
22:58:42,14,1000,499,654,419,2572
22:58:43,14,1001,492,653,616,2762
22:58:44,14,1001,466,652,544,2663
22:58:45,14,1001,509,650,754,2914
22:58:46,14,1000,502,653,490,2645
22:58:47,14,1000,502,657,640,2799
22:58:48,14,1001,491,658,281,2431
22:58:49,14,1000,487,657,481,2625
22:58:50,14,1000,491,657,564,2712
22:58:51,14,1000,528,657,518,2703
22:58:52,14,1000,511,656,510,2677
22:58:53,14,1000,496,655,940,3091
22:58:54,14,1001,482,654,915,3052
22:58:55,14,1000,500,653,812,2965
22:58:56,14,1000,497,653,903,3053
22:58:57,14,1000,476,652,925,3053
22:58:58,14,1000,505,649,895,3049
22:58:59,14,1000,497,649,933,3079
22:59:00,14,1000,489,647,845,2981
22:59:01,14,1000,492,647,991,3130
22:59:02,14,1000,492,645,849,2986
22:59:03,14,1001,491,646,914,3052
22:59:04,14,1000,502,644,993,3139
22:59:05,14,1000,502,644,911,3057
22:59:06,14,1000,497,644,807,2948
22:59:07,14,1000,508,643,917,3068
22:59:08,14,1000,487,643,891,3021
22:59:09,14,1000,480,642,891,3013
22:59:10,14,1000,482,641,900,3023
22:59:11,14,1000,495,640,850,2985
22:59:12,14,1000,486,641,905,3032
22:59:13,14,1000,482,643,883,3008
22:59:14,14,1000,491,646,859,2996
22:59:15,14,1000,494,649,962,3105
22:59:16,14,1000,502,652,902,3056
22:59:17,14,1000,487,652,934,3073
22:59:18,14,1000,501,652,872,3025
22:59:19,14,1000,501,653,922,3076
22:59:20,14,1000,506,654,966,3126
22:59:21,14,1000,487,655,940,3082
22:59:22,14,1000,496,654,846,2996
22:59:23,14,1000,496,654,948,3098
22:59:24,14,1000,494,654,855,3003
22:59:25,14,1001,478,654,970,3103
22:59:26,14,1000,499,655,977,3131
22:59:27,14,1000,491,655,928,3074
22:59:28,14,1001,485,655,893,3034
22:59:29,14,1001,494,655,933,3083
22:59:30,14,1001,501,655,933,3090
22:59:31,14,1000,491,655,858,3004
22:59:32,14,1001,493,655,891,3040
22:59:33,14,1001,480,657,946,3084
22:59:34,14,1001,470,656,913,3040
22:59:35,14,1001,476,656,862,2995
22:59:36,14,1001,487,655,930,3073
22:59:37,14,1000,499,658,838,2995
22:59:38,14,1000,492,658,857,3007
22:59:39,14,1000,496,658,902,3056
22:59:40,14,1000,498,657,883,3038
22:59:41,14,1000,487,657,889,3033
22:59:42,14,1000,494,657,917,3068
22:59:43,14,1000,498,657,897,3052
22:59:44,14,1000,489,656,926,3071
22:59:45,14,1000,493,655,934,3082
22:59:46,14,1000,495,655,949,3099
22:59:47,14,1000,494,655,908,3057
22:59:48,14,1000,502,656,888,3046
22:59:49,14,1000,493,655,842,2990
22:59:50,14,1001,490,654,927,3072
22:59:51,14,1001,496,653,911,3061
22:59:52,14,1000,516,652,957,3125
22:59:53,14,1000,499,652,919,3070
22:59:54,14,1000,496,650,868,3014
22:59:55,14,1001,492,650,977,3120
22:59:56,14,1000,495,649,826,2970
22:59:57,14,1000,489,648,996,3133
22:59:58,14,1001,493,648,946,3088
22:59:59,14,1001,483,645,904,3033
23:00:00,14,1001,489,645,809,2944
23:00:01,14,1001,499,643,915,3058
23:00:02,14,1000,499,642,888,3029
23:00:03,14,1000,488,642,945,3075
23:00:04,14,1001,492,641,969,3103
23:00:05,14,1000,503,641,859,3003
23:00:06,14,1000,495,641,955,3091
23:00:07,14,1001,487,640,881,3009
23:00:08,14,1001,494,640,916,3051
23:00:09,14,1000,493,640,928,3061
23:00:10,14,1000,494,639,903,3036
23:00:11,14,1001,494,638,962,3095
23:00:12,14,1001,492,638,870,3001
23:00:13,14,1001,497,635,883,3016
23:00:14,14,1000,512,636,879,3027
23:00:15,14,1001,511,635,900,3047
23:00:16,14,1001,499,634,853,2987
23:00:17,14,1000,501,634,908,3043
23:00:18,14,1001,482,633,913,3029
23:00:19,14,1001,477,633,809,2920
23:00:20,14,1000,466,633,936,3035
23:00:21,14,1000,498,633,898,3029
23:00:22,14,1001,479,634,960,3074
23:00:23,14,1000,496,635,860,2991
23:00:24,14,1000,494,635,917,3046
23:00:25,14,1000,492,634,901,3027
23:00:26,14,1000,481,632,905,3018
23:00:27,14,1000,493,632,920,3045
23:00:28,14,1000,482,632,902,3016
23:00:29,14,1000,490,630,908,3028
23:00:30,14,1000,468,631,975,3074
23:00:31,14,1000,498,630,910,3038
23:00:32,14,1000,509,630,882,3021
23:00:33,14,1000,490,630,895,3015
23:00:34,14,1000,488,629,866,2983
23:00:35,14,1000,501,629,934,3064
23:00:36,14,1000,498,628,922,3048
23:00:37,14,1001,491,628,963,3083
23:00:38,14,1000,492,627,869,2988
23:00:39,14,1000,489,626,936,3051
23:00:40,14,1001,478,626,949,3054
23:00:41,14,1001,491,625,949,3066
23:00:42,14,1001,501,625,965,3092
23:00:43,14,1000,486,625,930,3041
23:00:44,14,1000,491,626,972,3089
23:00:45,14,1000,485,625,924,3034
23:00:46,14,1000,484,624,948,3056
23:00:47,14,1000,479,624,991,3094
23:00:48,14,1000,499,624,949,3072
23:00:49,14,1000,481,623,965,3069
23:00:50,14,1000,492,623,975,3090
23:00:51,14,1000,520,623,937,3080
23:00:52,14,1000,490,622,938,3050
23:00:53,14,1001,495,622,954,3072
23:00:54,14,1001,503,620,966,3090
23:00:55,14,1001,491,619,963,3074
23:00:56,14,1000,485,618,958,3061
23:00:57,14,1000,488,618,946,3052
23:00:58,14,1000,487,618,22,2127
23:00:59,14,1001,490,618,130,2239
23:01:00,14,1001,486,618,207,2312
23:01:01,14,1000,486,618,130,2234
23:01:02,14,1001,514,617,88,2220
23:01:03,14,1001,497,617,97,2212
23:01:04,14,1001,514,617,134,2266
23:01:05,14,1000,485,615,87,2187
23:01:06,14,1000,492,614,38,2144
23:01:07,14,1001,498,614,146,2259
23:01:08,14,1001,489,614,101,2205
23:01:09,14,1001,500,614,222,2337
23:01:10,14,1001,458,614,78,2151
23:01:11,14,1000,477,614,171,2262
23:01:12,14,1000,443,614,186,2243
23:01:13,14,1000,483,614,173,2270
23:01:14,14,1000,507,613,89,2209
23:01:15,14,1000,475,612,123,2210
23:01:16,14,1000,488,611,244,2343
23:01:17,14,1001,502,610,173,2286
23:01:18,14,1001,492,610,69,2172
23:01:19,14,1000,479,609,5,2093
23:01:20,14,1000,495,608,1,2104
23:01:21,14,1001,501,608,0,2110
23:01:22,14,1001,493,609,4,2107
23:01:23,14,1000,480,609,4,2093
23:01:24,14,1001,482,609,3,2095
23:01:25,14,1001,494,608,2,2105
23:01:26,14,1001,485,608,0,2094
23:01:27,14,1000,499,607,3,2109
23:01:28,14,1000,493,607,4,2104
23:01:29,14,1000,497,606,5,2108
23:01:30,14,1000,484,605,2,2091
23:01:31,14,1001,478,605,0,2084
23:01:32,14,1000,487,604,3,2094
23:01:33,14,1001,540,604,2,2147
23:01:34,14,1000,484,604,1,2089
23:01:35,14,1000,497,604,1,2102
23:01:36,14,1001,503,604,3,2111
23:01:37,14,1001,445,603,3,2052
23:01:38,14,1001,470,603,1,2075
23:01:39,14,1000,531,603,3,2137
23:01:40,14,1000,486,602,2,2090
23:01:41,14,1001,440,602,3,2046
23:01:42,14,1000,497,601,0,2098
23:01:43,14,1001,520,601,5,2127
23:01:44,14,1000,500,600,4,2104
23:01:45,14,1001,491,600,1,2093
23:01:46,14,1001,504,600,4,2109
23:01:47,14,1001,499,599,3,2102
23:01:48,14,1001,479,599,4,2083
23:01:49,14,1000,502,598,3,2103
23:01:50,14,1001,495,598,2,2096
23:01:51,14,1001,491,598,1,2091
23:01:52,14,1001,540,598,2,2141
23:01:53,14,1000,485,598,1,2084
23:01:54,14,1000,527,598,2,2127
23:01:55,14,1000,526,598,0,2124
23:01:56,14,1000,497,598,1,2096
23:01:57,14,1001,487,597,1,2086
23:01:58,14,1000,485,597,1,2083
23:01:59,14,1001,483,597,2,2083
23:02:00,14,1000,488,596,1,2085
23:02:01,14,1001,502,596,1,2100
23:02:02,14,1000,472,595,1,2068
23:02:03,14,1000,577,594,0,2171
23:02:04,14,1001,502,594,1,2098
23:02:05,14,1001,446,594,1,2042
23:02:06,14,1000,522,593,1,2116
23:02:07,14,1001,496,593,1,2091
23:02:08,14,1000,494,593,1,2088
23:02:09,14,1001,488,593,1,2083
23:02:10,14,1000,494,593,1,2088
23:02:11,14,1001,513,593,1,2108
23:02:12,14,1000,470,592,0,2062
23:02:13,14,1001,483,592,1,2077
23:02:14,14,1001,483,593,1,2078
23:02:15,14,1001,468,592,0,2061
23:02:16,14,1000,496,591,0,2087
23:02:17,14,1000,499,590,1,2090
23:02:18,14,1001,500,590,1,2092
23:02:19,14,1001,493,589,0,2083
23:02:20,14,1000,511,589,1,2101
23:02:21,14,1001,506,589,2,2098
23:02:22,14,1000,488,588,1,2077
23:02:23,14,1001,490,589,1,2081
23:02:24,14,1001,505,588,0,2094
23:02:25,14,1001,508,588,0,2097
23:02:26,14,1001,492,588,1,2082
23:02:27,14,1000,487,588,1,2076
23:02:28,14,1001,472,588,1,2062
23:02:29,14,1001,488,588,2,2079
23:02:30,14,1000,479,587,1,2067
23:02:31,14,1000,492,587,1,2080
23:02:32,14,1000,491,587,0,2078
23:02:33,14,1001,480,587,2,2070
23:02:34,14,1001,483,586,2,2072
23:02:35,14,1000,494,585,1,2080
23:02:36,14,1001,505,585,0,2091
23:02:37,14,1001,493,584,1,2079
23:02:38,14,1000,496,584,0,2080
23:02:39,14,1001,497,584,1,2083
23:02:40,14,1001,494,584,1,2080
23:02:41,14,1000,486,584,0,2070
23:02:42,14,1001,492,584,0,2077
23:02:43,14,1001,500,583,0,2084
23:02:44,14,1000,500,584,1,2085
23:02:45,14,1000,480,584,1,2065
23:02:46,14,1001,475,583,0,2059
23:02:47,14,1001,489,583,1,2074
23:02:48,14,1001,497,583,0,2081
23:02:49,14,1001,488,583,0,2072
23:02:50,14,1000,505,583,0,2088
23:02:51,14,1001,500,583,1,2085
23:02:52,14,1001,480,582,2,2065
23:02:53,14,1001,496,582,2,2081
23:02:54,14,1000,494,582,0,2076
23:02:55,14,1001,487,582,0,2070
23:02:56,14,1001,489,582,1,2073
23:02:57,14,1000,490,582,0,2072
23:02:58,14,1001,497,581,1,2080
23:02:59,14,1000,492,581,1,2074
23:03:00,14,1001,498,581,0,2080
23:03:01,14,1001,487,581,1,2070
23:03:02,14,1001,463,581,1,2046
23:03:03,14,1001,495,581,1,2078
23:03:04,14,1001,492,581,1,2075
23:03:05,14,1001,495,580,0,2076
23:03:06,14,1001,492,579,0,2072
23:03:07,14,1001,504,579,0,2084
23:03:08,14,1001,497,578,1,2077
23:03:09,14,1001,494,578,1,2074
23:03:10,14,1000,496,577,0,2073
23:03:11,14,1000,497,577,1,2075
23:03:12,14,1001,492,577,0,2070
23:03:13,14,1001,491,575,1,2068
23:03:14,14,1001,489,575,1,2066
23:03:15,14,1001,492,575,1,2069
23:03:16,14,1001,501,575,2,2079
23:03:17,14,1000,494,575,0,2069
23:03:18,14,1000,490,574,0,2064
23:03:19,14,1000,488,574,1,2063
23:03:20,14,1001,496,575,1,2073
23:03:21,14,1001,493,574,0,2068
23:03:22,14,1001,509,574,2,2086
23:03:23,14,1001,498,574,0,2073
23:03:24,14,1000,499,574,1,2074
23:03:25,14,1001,494,574,1,2070
23:03:26,14,1001,499,574,0,2074
23:03:27,14,1001,501,574,0,2076
23:03:28,14,1001,493,574,2,2070
23:03:29,14,1001,498,574,1,2074
23:03:30,14,1000,498,574,1,2073
23:03:31,14,1000,489,574,2,2065
23:03:32,14,1000,497,574,1,2072
23:03:33,14,1001,493,574,0,2068
23:03:34,14,1001,496,574,0,2071
23:03:35,14,1001,502,575,2,2080
23:03:36,14,1001,492,575,0,2068
23:03:37,14,1001,492,575,0,2068
23:03:38,14,1001,493,575,1,2070
23:03:39,14,1001,497,575,2,2075
23:03:40,14,1000,493,575,1,2069
23:03:41,14,1001,491,575,0,2067
23:03:42,14,1001,492,575,1,2069
23:03:43,14,1001,495,575,0,2071
23:03:44,14,1001,487,575,0,2063
23:03:45,14,1001,489,575,0,2065
23:03:46,14,1001,490,575,2,2068
23:03:47,14,1001,491,574,1,2067
23:03:48,14,1001,493,574,0,2068
23:03:49,14,1001,492,574,1,2068
23:03:50,14,1000,488,574,1,2063
23:03:51,14,1001,485,574,1,2061
23:03:52,14,1001,501,573,2,2077
23:03:53,14,1000,487,573,1,2061
23:03:54,14,1000,502,573,0,2075
23:03:55,14,1000,489,573,0,2062
23:03:56,14,1001,494,573,1,2069
23:03:57,14,1000,501,573,2,2076
23:03:58,14,1001,500,573,2,2076
23:03:59,14,1001,494,573,2,2070
23:04:00,14,1001,495,572,0,2068
23:04:01,14,1001,499,572,1,2073
23:04:02,14,1001,498,573,0,2072
23:04:03,14,1000,489,572,0,2061
23:04:04,14,1001,492,572,1,2066
23:04:05,14,1001,484,572,1,2058
23:04:06,14,1001,493,572,1,2067
23:04:07,14,1000,493,572,0,2065
23:04:08,14,1001,493,572,1,2067
23:04:09,14,1001,498,572,1,2072
23:04:10,14,1001,498,572,1,2072
23:04:11,14,1000,489,572,1,2062
23:04:12,14,1001,496,572,0,2069
23:04:13,14,1000,488,572,0,2060
23:04:14,14,1000,493,572,1,2066
23:04:15,14,1001,496,572,2,2071
23:04:16,14,1001,491,571,1,2064
23:04:17,14,1001,491,571,2,2065
23:04:18,14,1001,490,571,1,2063
23:04:19,14,1001,495,571,1,2068
23:04:20,14,1000,503,571,0,2074
23:04:21,14,1001,496,571,1,2069
23:04:22,14,1000,504,570,0,2074
23:04:23,14,1000,490,570,1,2061
23:04:24,14,1000,487,570,0,2057
23:04:25,14,1000,498,570,1,2069
23:04:26,14,1000,486,570,1,2057
23:04:27,14,1000,488,570,1,2059
23:04:28,14,1000,495,569,0,2064
23:04:29,14,1000,492,569,0,2061
23:04:30,14,1000,498,569,0,2067
23:04:31,14,1000,491,569,1,2061
23:04:32,14,1000,493,569,0,2062
23:04:33,14,1000,495,569,2,2066
23:04:34,14,1000,491,569,2,2062
23:04:35,14,1000,494,568,1,2063
23:04:36,14,1000,496,569,1,2066
23:04:37,14,1000,496,568,0,2064
23:04:38,14,1000,502,568,2,2072
23:04:39,14,1000,495,568,1,2064
23:04:40,14,1000,497,568,1,2066
23:04:41,14,1000,487,568,2,2057
23:04:42,14,1000,486,567,1,2054
23:04:43,14,1000,488,567,0,2055
23:04:44,14,1000,500,567,1,2068
23:04:45,14,1000,501,567,1,2069
23:04:46,14,1000,498,567,0,2065
23:04:47,14,1000,495,567,0,2062
23:04:48,14,1000,494,567,1,2062
23:04:49,14,1000,489,567,1,2057
23:04:50,14,1000,497,566,1,2064
23:04:51,14,1000,487,566,1,2054
23:04:52,14,1000,493,566,1,2060
23:04:53,14,1000,486,566,1,2053
23:04:54,14,1000,491,566,0,2057
23:04:55,14,1000,486,566,1,2053
23:04:56,14,1000,494,565,0,2059
23:04:57,14,1000,498,565,1,2064
23:04:58,14,1000,499,565,0,2064
23:04:59,14,1000,500,566,1,2067
23:05:00,14,1000,493,565,1,2059
23:05:01,14,1000,495,565,1,2061
23:05:02,14,1000,499,565,0,2064
23:05:03,14,1000,485,565,1,2051
23:05:04,14,1000,498,565,1,2064
23:05:05,14,1000,501,565,1,2067
23:05:06,14,1000,492,565,1,2058
23:05:07,14,1000,493,564,1,2058
23:05:08,14,1000,495,565,1,2061
23:05:09,14,1000,502,564,0,2066
23:05:10,14,1000,489,564,2,2055
23:05:11,14,1000,503,564,1,2068
23:05:12,14,1000,500,564,1,2065
23:05:13,14,1000,499,564,0,2063
23:05:14,14,1000,487,564,2,2053
23:05:15,14,1000,501,564,1,2066
23:05:16,14,1000,486,564,1,2051
23:05:17,14,1000,495,563,1,2059
23:05:18,14,1000,495,564,2,2061
23:05:19,14,1000,499,563,1,2063
23:05:20,14,1000,493,563,1,2057
23:05:21,14,1000,494,563,0,2057
23:05:22,14,1000,491,563,1,2055
23:05:23,14,1000,487,563,0,2050
23:05:24,14,1000,491,563,0,2054
23:05:25,14,1000,502,562,1,2065
23:05:26,14,1000,493,562,0,2055
23:05:27,14,1000,492,562,2,2056
23:05:28,14,1000,497,562,0,2059
23:05:29,14,1000,495,561,0,2056
23:05:30,14,1000,501,561,2,2064
23:05:31,14,1000,486,561,0,2047
23:05:32,14,1000,489,561,2,2052
23:05:33,14,1000,493,561,0,2054
23:05:34,14,1000,497,561,1,2059
23:05:35,14,1000,493,561,1,2055
23:05:36,14,1000,498,561,1,2060
23:05:37,14,1000,493,561,1,2055
23:05:38,14,1000,490,562,2,2054
23:05:39,14,1000,497,561,1,2059
23:05:40,14,1000,491,562,1,2054
23:05:41,14,1000,502,562,1,2065
23:05:42,14,1000,491,561,1,2053
23:05:43,14,1001,489,561,1,2052
23:05:44,14,1000,496,562,1,2059
23:05:45,14,1000,470,562,1,2033
23:05:46,14,1000,501,562,0,2063
23:05:47,14,1000,493,562,0,2055
23:05:48,14,1000,490,562,0,2052
23:05:49,14,1000,488,562,0,2050
23:05:50,14,1000,499,562,1,2062
23:05:51,14,1000,491,562,0,2053
23:05:52,14,1000,494,561,0,2055
23:05:53,14,1000,496,561,1,2058
23:05:54,14,1000,495,561,0,2056
23:05:55,14,1000,491,561,1,2053
23:05:56,14,1000,492,560,0,2052
23:05:57,14,1000,489,560,0,2049
23:05:58,14,1001,493,560,1,2055
23:05:59,14,1000,498,560,1,2059
23:06:00,14,1000,494,560,1,2055
23:06:01,14,1000,500,560,0,2060
23:06:02,14,1000,494,560,2,2056
23:06:03,14,1000,491,560,2,2053
23:06:04,14,1000,498,559,0,2057
23:06:05,14,1000,501,559,1,2061
23:06:06,14,1000,493,559,1,2053
23:06:07,14,1000,488,559,2,2049
23:06:08,14,1000,494,559,0,2053
23:06:09,14,1000,482,559,0,2041
23:06:10,14,1000,491,558,1,2050
23:06:11,14,1000,491,558,1,2050
23:06:12,14,1000,499,558,2,2059
23:06:13,14,1000,485,558,1,2044
23:06:14,14,1000,492,558,1,2051
23:06:15,14,1001,503,558,0,2062
23:06:16,14,1000,493,557,1,2051
23:06:17,14,1000,488,557,1,2046
23:06:18,14,1000,498,557,1,2056
23:06:19,14,1000,488,557,1,2046
23:06:20,14,1000,489,557,1,2047
23:06:21,14,1000,489,557,1,2047
23:06:22,14,1000,493,557,1,2051
23:06:23,14,1000,494,557,0,2051
23:06:24,14,1000,489,557,2,2048
23:06:25,14,1000,492,557,0,2049
23:06:26,14,1000,494,557,2,2053
23:06:27,14,1000,497,556,1,2054
23:06:28,14,1000,501,556,0,2057
23:06:29,14,1000,502,556,0,2058
23:06:30,14,1000,494,556,2,2052
23:06:31,14,1000,492,556,1,2049
23:06:32,14,1000,486,556,1,2043
23:06:33,14,1000,480,556,1,2037
23:06:34,14,1000,488,556,1,2045
23:06:35,14,1000,492,556,0,2048
23:06:36,14,1000,501,556,1,2058
23:06:37,14,1000,493,556,1,2050
23:06:38,14,1000,497,556,0,2053
23:06:39,14,1000,498,556,0,2054
23:06:40,14,1000,500,556,2,2058
23:06:41,14,1000,495,556,1,2052
23:06:42,14,1000,485,556,2,2043
23:06:43,14,1000,498,556,1,2055
23:06:44,14,1000,503,556,1,2060
23:06:45,14,1000,497,556,1,2054
23:06:46,14,1000,495,555,1,2051
23:06:47,14,1000,492,556,2,2050
23:06:48,14,1001,492,555,0,2048
23:06:49,14,1000,511,555,2,2068
23:06:50,14,1000,489,555,2,2046
23:06:51,14,1000,491,555,1,2047
23:06:52,14,1000,487,555,0,2042
23:06:53,14,1000,496,555,0,2051
23:06:54,14,1000,491,555,2,2048
23:06:55,14,1000,497,555,1,2053
23:06:56,14,1000,498,555,1,2054
23:06:57,14,1001,490,555,1,2047
23:06:58,14,1000,490,555,1,2046
23:06:59,14,1000,498,555,0,2053
23:07:00,14,1001,482,555,0,2038
23:07:01,14,1000,490,555,2,2047
23:07:02,14,1000,500,555,1,2056
23:07:03,14,1000,503,555,1,2059
23:07:04,14,1000,497,556,0,2053
23:07:05,14,1002,488,547,0,2037
22:50:41,15,998,481,544,0,2023
22:50:42,15,998,0,544,0,1542
22:50:43,15,998,504,544,0,2046
22:50:44,15,0,0,0,0,0
22:50:45,15,998,489,545,0,2032
22:50:46,15,0,0,0,0,0
22:50:47,15,0,0,0,0,0
22:50:48,15,0,0,0,0,0
22:50:49,15,998,501,544,0,2043
22:50:50,15,998,496,544,0,2038
22:50:51,15,998,488,544,0,2030
22:50:52,15,998,485,544,0,2027
22:50:53,15,998,553,544,0,2095
22:50:54,15,998,491,544,0,2033
22:50:55,15,0,0,0,0,0
22:50:56,15,0,0,0,0,0
22:50:57,15,0,0,0,0,0
22:50:58,15,0,0,0,0,0
22:50:59,15,0,0,0,0,0
22:51:00,15,999,487,545,152,2183
22:51:01,15,0,0,0,0,0
22:51:02,15,0,0,0,0,0
22:51:03,15,999,502,545,564,2610
22:51:04,15,0,0,0,0,0
22:51:05,15,1000,447,545,310,2302
22:51:06,15,999,477,544,472,2492
22:51:07,15,0,0,0,0,0
22:51:08,15,0,0,0,0,0
22:51:09,15,0,0,0,0,0
22:51:10,15,0,0,0,0,0
22:51:11,15,998,494,544,542,2578
22:51:12,15,999,497,544,401,2441
22:51:13,15,999,500,544,715,2758
22:51:14,15,0,0,0,0,0
22:51:15,15,1000,505,547,301,2353
22:51:16,15,0,0,0,0,0
22:51:17,15,1000,474,551,517,2542
22:51:18,15,1002,484,589,742,2817
22:51:19,15,1001,504,591,328,2424
22:51:20,15,1002,482,597,527,2608
22:51:21,15,0,0,0,0,0
22:51:22,15,0,0,0,0,0
22:51:23,15,0,0,0,0,0
22:51:24,15,1002,496,620,355,2473
22:51:25,15,0,0,0,0,0
22:51:26,15,0,0,0,0,0
22:51:27,15,1002,502,637,626,2767
22:51:28,15,1000,493,637,529,2659
22:51:29,15,1000,499,637,427,2563
22:51:30,15,999,492,637,542,2670
22:51:31,15,1000,486,637,539,2662
22:51:32,15,0,0,0,0,0
22:51:33,15,1000,495,641,616,2752
22:51:34,15,1000,503,645,481,2629
22:51:35,15,1000,496,647,439,2582
22:51:36,15,0,0,0,0,0
22:51:37,15,0,0,0,0,0
22:51:38,15,0,0,0,0,0
22:51:39,15,0,0,0,0,0
22:51:40,15,999,469,649,621,2738
22:51:41,15,999,480,647,529,2655
22:51:42,15,999,455,646,563,2663
22:51:43,15,0,0,0,0,0
22:51:44,15,0,0,0,0,0
22:51:45,15,1000,496,647,569,2712
22:51:46,15,999,485,644,657,2785
22:51:47,15,0,0,0,0,0
22:51:48,15,1000,499,646,540,2685
22:51:49,15,999,480,652,395,2526
22:51:50,15,999,518,670,681,2868
22:51:51,15,999,492,669,560,2720
22:51:52,15,999,497,670,520,2686
22:51:53,15,998,512,668,906,3084
22:51:54,15,999,499,667,836,3001
22:51:55,15,999,507,664,843,3013
22:51:56,15,0,0,0,0,0
22:51:57,15,1000,497,663,888,3048
22:51:58,15,1000,505,664,815,2984
22:51:59,15,998,496,658,898,3050
22:52:00,15,999,498,657,909,3063
22:52:01,15,998,495,655,844,2992
22:52:02,15,999,497,655,932,3083
22:52:03,15,999,487,650,842,2978
22:52:04,15,999,505,649,886,3039
22:52:05,15,999,491,647,979,3116
22:52:06,15,999,490,646,836,2971
22:52:07,15,0,0,0,0,0
22:52:08,15,998,494,643,881,3016
22:52:09,15,999,510,642,975,3126
22:52:10,15,1000,487,647,912,3046
22:52:11,15,998,504,652,809,2963
22:52:12,15,999,493,651,873,3016
22:52:13,15,999,491,652,926,3068
22:52:14,15,999,494,652,862,3007
22:52:15,15,999,492,650,873,3014
22:52:16,15,998,495,649,858,3000
22:52:17,15,998,481,647,804,2930
22:52:18,15,0,0,0,0,0
22:52:19,15,999,498,646,886,3029
22:52:20,15,998,495,646,942,3081
22:52:21,15,998,499,652,839,2988
22:52:22,15,998,497,651,872,3018
22:52:23,15,999,497,652,952,3100
22:52:24,15,0,0,0,0,0
22:52:25,15,0,0,0,0,0
22:52:26,15,998,494,665,797,2954
22:52:27,15,998,493,666,889,3046
22:52:28,15,1000,499,666,953,3118
22:52:29,15,999,491,669,859,3018
22:52:30,15,999,494,672,821,2986
22:52:31,15,1001,495,676,937,3109
22:52:32,15,1002,490,680,936,3108
22:52:33,15,999,502,680,831,3012
22:52:34,15,999,498,681,863,3041
22:52:35,15,1000,511,681,771,2963
22:52:36,15,999,490,681,865,3035
22:52:37,15,999,481,681,894,3055
22:52:38,15,998,491,682,878,3049
22:52:39,15,998,494,680,939,3111
22:52:40,15,999,486,680,909,3074
22:52:41,15,998,491,680,859,3028
22:52:42,15,998,491,681,905,3075
22:52:43,15,998,477,682,931,3088
22:52:44,15,999,494,682,819,2994
22:52:45,15,998,501,681,895,3075
22:52:46,15,998,496,681,889,3064
22:52:47,15,998,494,681,858,3031
22:52:48,15,999,482,681,936,3098
22:52:49,15,998,495,681,900,3074
22:52:50,15,998,483,681,976,3138
22:52:51,15,998,505,681,879,3063
22:52:52,15,998,494,679,869,3040
22:52:53,15,998,495,678,851,3022
22:52:54,15,998,497,678,886,3059
22:52:55,15,998,491,678,842,3009
22:52:56,15,999,492,680,882,3053
22:52:57,15,1001,486,683,848,3018
22:52:58,15,1000,497,686,890,3073
22:52:59,15,999,487,688,993,3167
22:53:00,15,998,505,686,868,3057
22:53:01,15,998,493,688,833,3012
22:53:02,15,998,490,687,856,3031
22:53:03,15,998,496,686,893,3073
22:53:04,15,998,489,684,818,2989
22:53:05,15,998,499,684,924,3105
22:53:06,15,998,496,682,917,3093
22:53:07,15,998,493,682,878,3051
22:53:08,15,998,484,681,927,3090
22:53:09,15,998,500,682,887,3067
22:53:10,15,998,494,680,921,3093
22:53:11,15,998,485,680,826,2989
22:53:12,15,998,502,680,901,3081
22:53:13,15,998,490,679,891,3058
22:53:14,15,999,496,678,892,3065
22:53:15,15,998,498,676,783,2955
22:53:16,15,999,494,675,830,2998
22:53:17,15,0,0,0,0,0
22:53:18,15,0,0,0,0,0
22:53:19,15,998,494,672,765,2929
22:53:20,15,999,491,670,899,3059
22:53:21,15,998,484,668,802,2952
22:53:22,15,998,494,666,914,3072
22:53:23,15,998,495,666,850,3009
22:53:24,15,998,501,665,951,3115
22:53:25,15,999,492,664,946,3101
22:53:26,15,999,497,663,796,2955
22:53:27,15,999,492,661,906,3058
22:53:28,15,999,494,660,862,3015
22:53:29,15,0,0,0,0,0
22:53:30,15,999,493,658,890,3040
22:53:31,15,998,496,657,858,3009
22:53:32,15,999,495,655,858,3007
22:53:33,15,999,497,654,876,3026
22:53:34,15,998,485,654,857,2994
22:53:35,15,999,492,655,877,3023
22:53:36,15,999,495,657,851,3002
22:53:37,15,999,494,657,830,2980
22:53:38,15,999,487,659,830,2975
22:53:39,15,999,494,659,871,3023
22:53:40,15,999,489,660,893,3041
22:53:41,15,1000,493,660,849,3002
22:53:42,15,999,494,662,889,3044
22:53:43,15,999,496,662,865,3022
22:53:44,15,999,495,663,945,3102
22:53:45,15,999,494,663,908,3064
22:53:46,15,999,497,664,897,3057
22:53:47,15,999,491,663,891,3044
22:53:48,15,999,497,662,865,3023
22:53:49,15,999,491,662,890,3042
22:53:50,15,999,503,662,853,3017
22:53:51,15,999,499,661,849,3008
22:53:52,15,999,495,661,925,3080
22:53:53,15,998,496,659,815,2968
22:53:54,15,998,498,658,853,3007
22:53:55,15,999,494,658,942,3093
22:53:56,15,998,494,656,944,3092
22:53:57,15,998,494,654,910,3056
22:53:58,15,1000,501,654,890,3045
22:53:59,15,999,492,653,885,3029
22:54:00,15,0,0,0,0,0
22:54:01,15,998,495,652,773,2918
22:54:02,15,998,489,653,821,2961
22:54:03,15,999,495,653,861,3008
22:54:04,15,999,464,653,779,2895
22:54:05,15,999,490,653,848,2990
22:54:06,15,998,494,652,812,2956
22:54:07,15,999,483,653,787,2922
22:54:08,15,999,492,652,894,3037
22:54:09,15,999,491,651,860,3001
22:54:10,15,998,489,651,837,2975
22:54:11,15,0,0,0,0,0
22:54:12,15,998,520,654,844,3016
22:54:13,15,998,495,657,854,3004
22:54:14,15,998,499,657,828,2982
22:54:15,15,998,494,656,838,2986
22:54:16,15,998,489,656,989,3132
22:54:17,15,997,489,657,877,3020
22:54:18,15,997,498,657,882,3034
22:54:19,15,998,494,657,859,3008
22:54:20,15,998,490,657,844,2989
22:54:21,15,998,495,656,883,3032
22:54:22,15,999,496,656,884,3035
22:54:23,15,998,492,655,922,3067
22:54:24,15,999,504,655,896,3054
22:54:25,15,999,494,655,888,3036
22:54:26,15,0,0,0,0,0
22:54:27,15,999,501,655,865,3020
22:54:28,15,0,0,0,0,0
22:54:29,15,998,496,654,875,3023
22:54:30,15,999,496,653,953,3101
22:54:31,15,999,489,653,804,2945
22:54:32,15,999,494,653,853,2999
22:54:33,15,999,495,653,820,2967
22:54:34,15,998,488,653,885,3024
22:54:35,15,999,497,653,849,2998
22:54:36,15,999,496,653,819,2967
22:54:37,15,999,511,653,804,2967
22:54:38,15,999,492,652,885,3028
22:54:39,15,999,491,651,858,2999
22:54:40,15,999,497,651,896,3043
22:54:41,15,999,501,652,863,3015
22:54:42,15,0,0,0,0,0
22:54:43,15,0,0,0,0,0
22:54:44,15,999,491,656,874,3020
22:54:45,15,999,483,655,873,3010
22:54:46,15,999,488,652,854,2993
22:54:47,15,999,493,652,834,2978
22:54:48,15,998,489,650,855,2992
22:54:49,15,999,501,649,982,3131
22:54:50,15,998,496,647,802,2943
22:54:51,15,999,498,647,865,3009
22:54:52,15,998,490,644,880,3012
22:54:53,15,999,497,643,903,3042
22:54:54,15,999,495,640,841,2975
22:54:55,15,999,496,639,907,3041
22:54:56,15,999,498,638,864,2999
22:54:57,15,999,492,636,841,2968
22:54:58,15,999,494,635,855,2983
22:54:59,15,0,0,0,0,0
22:55:00,15,999,490,634,857,2980
22:55:01,15,999,504,633,917,3053
22:55:02,15,999,492,632,873,2996
22:55:03,15,999,497,630,865,2991
22:55:04,15,999,492,630,859,2980
22:55:05,15,999,491,629,878,2997
22:55:06,15,999,491,628,849,2967
22:55:07,15,999,499,627,955,3080
22:55:08,15,999,492,626,888,3005
22:55:09,15,999,496,625,863,2983
22:55:10,15,0,0,0,0,0
22:55:11,15,999,499,624,882,3004
22:55:12,15,1000,489,622,820,2931
22:55:13,15,999,491,621,865,2976
22:55:14,15,999,492,620,881,2992
22:55:15,15,999,496,620,866,2981
22:55:16,15,999,487,619,935,3040
22:55:17,15,999,493,618,902,3012
22:55:18,15,999,494,618,850,2961
22:55:19,15,999,498,618,893,3008
22:55:20,15,999,484,618,937,3038
22:55:21,15,999,497,617,832,2945
22:55:22,15,999,496,617,866,2978
22:55:23,15,998,496,616,816,2926
22:55:24,15,999,493,616,942,3050
22:55:25,15,999,493,616,873,2981
22:55:26,15,999,498,615,842,2954
22:55:27,15,999,489,615,885,2988
22:55:28,15,999,492,614,841,2946
22:55:29,15,999,493,613,883,2988
22:55:30,15,999,497,613,878,2987
22:55:31,15,999,496,612,823,2930
22:55:32,15,999,501,612,926,3038
22:55:33,15,999,493,612,842,2946
22:55:34,15,1000,479,613,932,3024
22:55:35,15,999,500,613,861,2973
22:55:36,15,999,495,612,847,2953
22:55:37,15,999,493,612,811,2915
22:55:38,15,999,499,612,786,2896
22:55:39,15,999,484,612,463,2558
22:55:40,15,999,492,613,407,2511
22:55:41,15,999,496,613,476,2584
22:55:42,15,999,491,614,330,2434
22:55:43,15,999,487,615,303,2404
22:55:44,15,999,495,615,340,2449
22:55:45,15,999,499,615,614,2727
22:55:46,15,999,494,616,391,2500
22:55:47,15,999,493,617,800,2909
22:55:48,15,999,492,617,570,2678
22:55:49,15,999,495,618,523,2635
22:55:50,15,999,499,619,437,2554
22:55:51,15,999,496,619,394,2508
22:55:52,15,999,483,620,630,2732
22:55:53,15,999,493,621,521,2634
22:55:54,15,999,495,621,599,2714
22:55:55,15,999,490,621,709,2819
22:55:56,15,999,491,620,632,2742
22:55:57,15,1000,495,620,307,2422
22:55:58,15,0,0,0,0,0
22:55:59,15,1000,490,619,508,2617
22:56:00,15,1000,491,620,446,2557
22:56:01,15,1000,488,620,569,2677
22:56:02,15,1000,481,619,523,2623
22:56:03,15,1000,488,620,551,2659
22:56:04,15,999,498,619,519,2635
22:56:05,15,999,498,619,573,2689
22:56:06,15,999,491,618,585,2693
22:56:07,15,999,494,620,518,2631
22:56:08,15,999,497,621,546,2663
22:56:09,15,999,490,622,498,2609
22:56:10,15,999,498,624,615,2736
22:56:11,15,999,492,625,473,2589
22:56:12,15,999,502,626,609,2736
22:56:13,15,0,0,0,0,0
22:56:14,15,999,493,627,441,2560
22:56:15,15,999,499,628,531,2657
22:56:16,15,999,504,627,612,2742
22:56:17,15,999,494,628,543,2664
22:56:18,15,999,493,628,482,2602
22:56:19,15,999,492,627,934,3052
22:56:20,15,999,493,627,903,3022
22:56:21,15,999,502,627,932,3060
22:56:22,15,1000,493,626,882,3001
22:56:23,15,999,487,627,995,3108
22:56:24,15,999,491,627,907,3024
22:56:25,15,1000,490,627,944,3061
22:56:26,15,1000,496,627,817,2940
22:56:27,15,999,489,627,913,3028
22:56:28,15,999,498,627,854,2978
22:56:29,15,1000,499,626,905,3030
22:56:30,15,1000,491,626,929,3046
22:56:31,15,999,495,627,883,3004
22:56:32,15,999,488,626,880,2993
22:56:33,15,999,490,626,837,2952
22:56:34,15,999,494,625,909,3027
22:56:35,15,999,493,625,921,3038
22:56:36,15,0,0,0,0,0
22:56:37,15,999,495,624,945,3063
22:56:38,15,999,471,622,938,3030
22:56:39,15,999,482,620,894,2995
22:56:40,15,1000,487,620,481,2588
22:56:41,15,999,485,620,461,2565
22:56:42,15,999,491,618,382,2490
22:56:43,15,1000,494,619,300,2413
22:56:44,15,999,495,617,523,2634
22:56:45,15,999,497,616,549,2661
22:56:46,15,997,502,615,469,2583
22:56:47,15,996,497,614,489,2596
22:56:48,15,997,470,613,605,2685
22:56:49,15,998,488,612,387,2485
22:56:50,15,997,491,612,492,2592
22:56:51,15,997,496,611,554,2658
22:56:52,15,997,488,610,480,2575
22:56:53,15,997,491,610,515,2613
22:56:54,15,996,494,610,513,2613
22:56:55,15,997,496,609,530,2632
22:56:56,15,996,493,609,446,2544
22:56:57,15,997,490,609,465,2561
22:56:58,15,997,491,609,497,2594
22:56:59,15,997,497,609,512,2615
22:57:00,15,996,490,608,464,2558
22:57:01,15,997,506,608,452,2563
22:57:02,15,997,500,611,587,2695
22:57:03,15,998,480,619,465,2562
22:57:04,15,998,496,625,476,2595
22:57:05,15,998,497,623,544,2662
22:57:06,15,999,482,622,468,2571
22:57:07,15,999,500,622,477,2598
22:57:08,15,999,492,620,673,2784
22:57:09,15,999,491,619,485,2594
22:57:10,15,999,489,619,302,2409
22:57:11,15,999,487,618,502,2606
22:57:12,15,999,495,617,494,2605
22:57:13,15,999,491,616,557,2663
22:57:14,15,999,509,615,410,2533
22:57:15,15,999,501,614,445,2559
22:57:16,15,999,497,614,327,2437
22:57:17,15,999,505,614,710,2828
22:57:18,15,1000,491,613,366,2470
22:57:19,15,999,526,613,493,2631
22:57:20,15,0,0,0,0,0
22:57:21,15,999,498,612,611,2720
22:57:22,15,999,491,612,877,2979
22:57:23,15,999,470,610,912,2991
22:57:24,15,999,489,610,882,2980
22:57:25,15,999,501,609,907,3016
22:57:26,15,999,485,609,907,3000
22:57:27,15,999,498,608,874,2979
22:57:28,15,999,495,608,878,2980
22:57:29,15,999,495,607,905,3006
22:57:30,15,1000,485,607,884,2976
22:57:31,15,1000,489,607,886,2982
22:57:32,15,999,488,606,914,3007
22:57:33,15,999,497,606,967,3069
22:57:34,15,998,499,606,878,2981
22:57:35,15,998,490,606,898,2992
22:57:36,15,999,498,607,918,3022
22:57:37,15,998,495,608,898,2999
22:57:38,15,999,489,607,872,2967
22:57:39,15,999,504,608,837,2948
22:57:40,15,999,492,608,903,3002
22:57:41,15,999,494,608,936,3037
22:57:42,15,999,492,608,893,2992
22:57:43,15,999,490,608,864,2961
22:57:44,15,0,0,0,0,0
22:57:45,15,999,498,609,930,3036
22:57:46,15,1000,494,609,814,2917
22:57:47,15,1000,496,609,882,2987
22:57:48,15,0,0,0,0,0
22:57:49,15,1000,498,610,927,3035
22:57:50,15,1000,484,609,928,3021
22:57:51,15,1000,498,609,919,3026
22:57:52,15,1000,498,609,892,2999
22:57:53,15,1000,494,609,893,2996
22:57:54,15,1000,492,609,781,2882
22:57:55,15,1000,496,608,450,2554
22:57:56,15,1000,495,608,505,2608
22:57:57,15,1000,489,607,540,2636
22:57:58,15,1000,492,606,557,2655
22:57:59,15,1001,493,606,350,2450
22:58:00,15,1000,493,605,689,2787
22:58:01,15,1000,497,605,515,2617
22:58:02,15,1000,486,605,445,2536
22:58:03,15,1001,485,604,424,2514
22:58:04,15,1001,497,604,308,2410
22:58:05,15,1001,490,602,583,2676
22:58:06,15,1000,496,601,501,2598
22:58:07,15,1000,496,601,530,2627
22:58:08,15,1000,493,600,632,2725
22:58:09,15,1000,492,600,452,2544
22:58:10,15,1000,499,600,456,2555
22:58:11,15,1000,495,599,699,2793
22:58:12,15,1000,491,599,611,2701
22:58:13,15,1000,496,600,929,3025
22:58:14,15,1000,494,602,855,2951
22:58:15,15,1001,488,604,943,3036
22:58:16,15,1000,503,605,855,2963
22:58:17,15,0,0,0,0,0
22:58:18,15,1000,490,610,954,3054
22:58:19,15,1000,494,614,894,3002
22:58:20,15,999,495,622,908,3024
22:58:21,15,998,490,624,906,3018
22:58:22,15,999,493,625,833,2950
22:58:23,15,998,494,625,854,2971
22:58:24,15,998,490,627,921,3036
22:58:25,15,999,493,627,871,2990
22:58:26,15,999,492,626,920,3037
22:58:27,15,1000,495,625,918,3038
22:58:28,15,1000,483,624,885,2992
22:58:29,15,1000,496,624,859,2979
22:58:30,15,1000,490,623,852,2965
22:58:31,15,1001,500,623,832,2956
22:58:32,15,1000,493,623,910,3026
22:58:33,15,1000,493,622,899,3014
22:58:34,15,1001,496,622,908,3027
22:58:35,15,1000,491,621,860,2972
22:58:36,15,1000,490,621,899,3010
22:58:37,15,1000,494,619,879,2992
22:58:38,15,999,497,618,958,3072
22:58:39,15,1000,498,618,924,3040
22:58:40,15,1000,504,618,969,3091
22:58:41,15,999,495,618,894,3006
22:58:42,15,1000,494,618,810,2922
22:58:43,15,1000,497,617,830,2944
22:58:44,15,1001,495,617,885,2998
22:58:45,15,999,494,616,924,3033
22:58:46,15,1000,495,616,982,3093
22:58:47,15,0,0,0,0,0
22:58:48,15,1000,495,615,881,2991
22:58:49,15,1000,495,615,912,3022
22:58:50,15,999,455,614,884,2952
22:58:51,15,1000,495,613,933,3041
22:58:52,15,999,499,613,882,2993
22:58:53,15,999,496,612,934,3041
22:58:54,15,999,497,611,901,3008
22:58:55,15,1000,480,611,936,3027
22:58:56,15,1000,496,610,889,2995
22:58:57,15,1000,467,609,872,2948
22:58:58,15,1000,493,608,895,2996
22:58:59,15,999,494,608,945,3046
22:59:00,15,999,498,607,891,2995
22:59:01,15,1000,496,606,975,3077
22:59:02,15,1000,496,606,897,2999
22:59:03,15,1000,492,605,902,2999
22:59:04,15,1000,456,605,904,2965
22:59:05,15,999,404,605,895,2903
22:59:06,15,1000,271,605,873,2749
22:59:07,15,1000,507,605,923,3035
22:59:08,15,1002,523,606,925,3056
22:59:09,15,1001,431,606,856,2894
22:59:10,15,1001,495,605,949,3050
22:59:11,15,1000,488,604,882,2974
22:59:12,15,1001,494,604,879,2978
22:59:13,15,1000,505,604,869,2978
22:59:14,15,1000,488,604,922,3014
22:59:15,15,1001,489,603,879,2972
22:59:16,15,1001,495,603,928,3027
22:59:17,15,1001,489,603,863,2956
22:59:18,15,1001,494,603,885,2983
22:59:19,15,1001,491,603,868,2963
22:59:20,15,1000,495,602,912,3009
22:59:21,15,1000,492,605,920,3017
22:59:22,15,1000,492,605,912,3009
22:59:23,15,1000,494,610,927,3031
22:59:24,15,999,493,609,920,3021
22:59:25,15,999,493,609,840,2941
22:59:26,15,1000,497,609,906,3012
22:59:27,15,999,494,609,860,2962
22:59:28,15,1000,493,608,904,3005
22:59:29,15,1000,503,608,875,2986
22:59:30,15,999,499,607,896,3001
22:59:31,15,1000,491,608,981,3080
22:59:32,15,999,491,607,910,3007
22:59:33,15,1000,491,607,910,3008
22:59:34,15,1000,486,613,923,3022
22:59:35,15,999,491,618,902,3010
22:59:36,15,999,491,618,935,3043
22:59:37,15,999,487,618,955,3059
22:59:38,15,999,494,618,875,2986
22:59:39,15,999,500,617,886,3002
22:59:40,15,1000,492,617,934,3043
22:59:41,15,999,484,617,910,3010
22:59:42,15,1000,510,617,878,3005
22:59:43,15,1000,495,617,957,3069
22:59:44,15,1000,485,616,907,3008
22:59:45,15,999,491,616,894,3000
22:59:46,15,999,500,616,871,2986
22:59:47,15,1000,495,616,846,2957
22:59:48,15,999,492,615,931,3037
22:59:49,15,999,492,615,914,3020
22:59:50,15,999,506,616,932,3053
22:59:51,15,999,490,615,885,2989
22:59:52,15,0,0,0,0,0
22:59:53,15,1000,490,614,921,3025
22:59:54,15,999,496,613,870,2978
22:59:55,15,999,498,612,931,3040
22:59:56,15,1000,490,611,917,3018
22:59:57,15,999,488,610,883,2980
22:59:58,15,999,496,609,902,3006
22:59:59,15,999,488,609,945,3041
23:00:00,15,1001,488,608,939,3036
23:00:01,15,1000,497,608,947,3052
23:00:02,15,999,493,607,960,3059
23:00:03,15,999,495,607,958,3059
23:00:04,15,1000,496,606,919,3021
23:00:05,15,1000,494,606,931,3031
23:00:06,15,1000,496,605,913,3014
23:00:07,15,1000,490,605,961,3056
23:00:08,15,1000,490,604,955,3049
23:00:09,15,1000,489,603,941,3033
23:00:10,15,1000,489,603,955,3047
23:00:11,15,1001,495,602,952,3050
23:00:12,15,1001,499,601,929,3030
23:00:13,15,1000,497,600,983,3080
23:00:14,15,1001,487,600,959,3047
23:00:15,15,1001,490,599,948,3038
23:00:16,15,1000,495,600,949,3044
23:00:17,15,1000,493,601,985,3079
23:00:18,15,1000,494,600,161,2255
23:00:19,15,1000,496,600,92,2188
23:00:20,15,1001,489,600,105,2195
23:00:21,15,1001,491,600,101,2193
23:00:22,15,1000,493,600,99,2192
23:00:23,15,1000,503,601,52,2156
23:00:24,15,1000,482,601,135,2218
23:00:25,15,999,495,601,115,2210
23:00:26,15,999,488,601,176,2264
23:00:27,15,1000,499,601,162,2262
23:00:28,15,1000,504,600,105,2209
23:00:29,15,999,497,600,183,2279
23:00:30,15,1000,493,599,144,2236
23:00:31,15,1000,484,598,125,2207
23:00:32,15,1001,493,598,120,2212
23:00:33,15,1000,500,598,168,2266
23:00:34,15,1000,483,597,137,2217
23:00:35,15,1001,487,597,107,2192
23:00:36,15,1000,493,597,152,2242
23:00:37,15,1000,499,596,85,2180
23:00:38,15,1000,496,596,130,2222
23:00:39,15,1000,498,595,2,2095
23:00:40,15,1000,479,595,2,2076
23:00:41,15,1001,467,595,1,2064
23:00:42,15,1001,498,594,1,2094
23:00:43,15,1001,487,594,1,2083
23:00:44,15,1001,501,593,1,2096
23:00:45,15,1001,490,593,3,2087
23:00:46,15,1000,487,592,3,2082
23:00:47,15,1001,494,592,2,2089
23:00:48,15,1001,491,591,2,2085
23:00:49,15,1001,480,591,2,2074
23:00:50,15,1001,493,591,2,2087
23:00:51,15,1001,491,591,2,2085
23:00:52,15,1001,501,590,4,2096
23:00:53,15,1001,501,590,3,2095
23:00:54,15,1001,492,589,3,2085
23:00:55,15,1001,498,589,2,2090
23:00:56,15,1001,502,588,3,2094
23:00:57,15,1001,499,588,2,2090
23:00:58,15,1001,485,588,5,2079
23:00:59,15,1001,495,587,2,2085
23:01:00,15,1001,495,587,2,2085
23:01:01,15,0,0,0,0,0
23:01:02,15,1000,492,587,1,2080
23:01:03,15,1001,510,586,4,2101
23:01:04,15,1001,529,586,2,2118
23:01:05,15,1001,496,586,2,2085
23:01:06,15,1001,495,586,3,2085
23:01:07,15,1001,497,586,1,2085
23:01:08,15,1001,486,585,3,2075
23:01:09,15,1001,500,585,2,2088
23:01:10,15,1001,492,585,5,2083
23:01:11,15,1001,483,585,3,2072
23:01:12,15,1001,481,585,3,2070
23:01:13,15,1001,487,584,1,2073
23:01:14,15,1001,489,584,1,2075
23:01:15,15,1001,484,583,0,2068
23:01:16,15,1001,492,583,0,2076
23:01:17,15,1000,477,582,1,2060
23:01:18,15,1001,484,582,1,2068
23:01:19,15,1001,483,581,1,2066
23:01:20,15,1001,475,581,1,2058
23:01:21,15,1001,484,580,0,2065
23:01:22,15,1001,493,580,0,2074
23:01:23,15,1001,484,580,0,2065
23:01:24,15,1001,468,579,0,2048
23:01:25,15,0,0,0,0,0
23:01:26,15,1000,491,579,1,2071
23:01:27,15,1001,461,578,0,2040
23:01:28,15,1000,501,578,0,2079
23:01:29,15,1000,524,578,1,2103
23:01:30,15,1001,508,577,0,2086
23:01:31,15,1001,500,577,0,2078
23:01:32,15,1000,475,577,0,2052
23:01:33,15,1001,499,576,1,2077
23:01:34,15,1000,495,576,1,2072
23:01:35,15,1000,496,575,1,2072
23:01:36,15,1001,493,575,0,2069
23:01:37,15,1001,491,575,1,2068
23:01:38,15,1000,481,574,1,2056
23:01:39,15,1000,487,574,1,2062
23:01:40,15,1000,492,573,1,2066
23:01:41,15,1000,491,573,1,2065
23:01:42,15,1000,496,573,1,2070
23:01:43,15,1001,495,573,1,2070
23:01:44,15,1000,498,573,0,2071
23:01:45,15,1000,492,572,1,2065
23:01:46,15,1000,495,572,0,2067
23:01:47,15,1000,486,572,0,2058
23:01:48,15,1000,495,572,1,2068
23:01:49,15,1000,493,571,0,2064
23:01:50,15,1000,497,571,1,2069
23:01:51,15,999,496,571,1,2067
23:01:52,15,1000,495,571,0,2066
23:01:53,15,999,501,571,1,2072
23:01:54,15,1000,495,571,1,2067
23:01:55,15,1000,489,571,2,2062
23:01:56,15,1000,501,570,1,2072
23:01:57,15,1000,494,570,0,2064
23:01:58,15,999,499,570,1,2069
23:01:59,15,999,500,570,1,2070
23:02:00,15,999,498,569,1,2067
23:02:01,15,999,490,569,1,2059
23:02:02,15,999,500,569,0,2068
23:02:03,15,1000,491,569,1,2061
23:02:04,15,1000,488,569,1,2058
23:02:05,15,1000,494,569,1,2064
23:02:06,15,1000,491,568,1,2060
23:02:07,15,999,497,568,1,2065
23:02:08,15,999,495,568,0,2062
23:02:09,15,999,494,568,1,2062
23:02:10,15,999,492,568,1,2060
23:02:11,15,999,494,567,1,2061
23:02:12,15,998,496,567,1,2062
23:02:13,15,998,492,567,0,2057
23:02:14,15,999,488,567,1,2055
23:02:15,15,998,768,567,1,2334
23:02:16,15,998,491,567,0,2056
23:02:17,15,998,491,567,0,2056
23:02:18,15,998,498,567,2,2065
23:02:19,15,998,500,567,1,2066
23:02:20,15,998,497,566,1,2062
23:02:21,15,998,502,566,1,2067
23:02:22,15,998,491,566,1,2056
23:02:23,15,998,497,566,0,2061
23:02:24,15,998,493,566,0,2057
23:02:25,15,998,494,565,0,2057
23:02:26,15,999,489,565,2,2055
23:02:27,15,999,495,565,1,2060
23:02:28,15,999,503,564,0,2066
23:02:29,15,998,496,564,0,2058
23:02:30,15,998,493,563,1,2055
23:02:31,15,998,498,563,1,2060
23:02:32,15,998,491,563,0,2052
23:02:33,15,998,499,563,1,2061
23:02:34,15,999,518,563,2,2082
23:02:35,15,998,488,563,1,2050
23:02:36,15,998,499,562,0,2059
23:02:37,15,998,496,563,0,2057
23:02:38,15,998,493,562,0,2053
23:02:39,15,998,502,562,1,2063
23:02:40,15,998,496,562,2,2058
23:02:41,15,998,487,561,1,2047
23:02:42,15,998,490,561,1,2050
23:02:43,15,998,493,561,1,2053
23:02:44,15,998,491,561,1,2051
23:02:45,15,998,488,561,1,2048
23:02:46,15,998,496,561,0,2055
23:02:47,15,999,488,561,1,2049
23:02:48,15,998,496,561,1,2056
23:02:49,15,998,491,561,1,2051
23:02:50,15,998,496,561,1,2056
23:02:51,15,998,495,560,1,2054
23:02:52,15,998,493,560,0,2051
23:02:53,15,998,493,560,1,2052
23:02:54,15,998,492,560,1,2051
23:02:55,15,998,495,560,1,2054
23:02:56,15,999,476,560,0,2035
23:02:57,15,0,0,0,0,0
23:02:58,15,998,495,560,0,2053
23:02:59,15,998,492,559,0,2049
23:03:00,15,998,496,560,1,2055
23:03:01,15,998,494,559,1,2052
23:03:02,15,998,489,559,0,2046
23:03:03,15,998,495,559,1,2053
23:03:04,15,998,490,559,0,2047
23:03:05,15,998,491,559,0,2048
23:03:06,15,998,490,559,1,2048
23:03:07,15,998,495,559,0,2052
23:03:08,15,997,492,558,1,2048
23:03:09,15,997,495,558,1,2051
23:03:10,15,997,482,558,0,2037
23:03:11,15,998,498,558,1,2055
23:03:12,15,997,499,558,1,2055
23:03:13,15,998,494,558,1,2051
23:03:14,15,997,496,558,1,2052
23:03:15,15,997,491,558,0,2046
23:03:16,15,997,493,558,1,2049
23:03:17,15,997,494,558,1,2050
23:03:18,15,997,493,558,1,2049
23:03:19,15,998,493,557,1,2049
23:03:20,15,999,504,557,0,2060
23:03:21,15,998,490,557,1,2046
23:03:22,15,999,497,558,0,2054
23:03:23,15,998,496,557,1,2052
23:03:24,15,999,488,557,1,2045
23:03:25,15,998,493,557,1,2049
23:03:26,15,998,493,557,0,2048
23:03:27,15,999,490,557,1,2047
23:03:28,15,999,493,556,0,2048
23:03:29,15,998,489,557,1,2045
23:03:30,15,999,489,556,0,2044
23:03:31,15,998,489,557,1,2045
23:03:32,15,999,490,556,1,2046
23:03:33,15,999,496,556,1,2052
23:03:34,15,999,491,556,0,2046
23:03:35,15,998,498,556,1,2053
23:03:36,15,999,497,556,1,2053
23:03:37,15,998,491,555,0,2044
23:03:38,15,999,494,555,1,2049
23:03:39,15,999,496,555,0,2050
23:03:40,15,999,490,555,0,2044
23:03:41,15,998,498,554,0,2050
23:03:42,15,998,494,554,1,2047
23:03:43,15,998,496,554,1,2049
23:03:44,15,998,498,554,0,2050
23:03:45,15,998,495,554,1,2048
23:03:46,15,998,495,554,0,2047
23:03:47,15,998,492,554,1,2045
23:03:48,15,998,496,554,1,2049
23:03:49,15,999,498,554,0,2051
23:03:50,15,998,495,554,1,2048
23:03:51,15,999,484,553,0,2036
23:03:52,15,998,488,553,1,2040
23:03:53,15,998,493,553,1,2045
23:03:54,15,998,490,553,0,2041
23:03:55,15,998,491,553,0,2042
23:03:56,15,998,495,553,1,2047
23:03:57,15,998,489,552,0,2039
23:03:58,15,998,495,552,0,2045
23:03:59,15,998,489,552,1,2040
23:04:00,15,997,490,552,0,2039
23:04:01,15,998,488,552,1,2039
23:04:02,15,997,490,552,1,2040
23:04:03,15,998,488,552,2,2040
23:04:04,15,998,485,551,1,2035
23:04:05,15,998,496,551,1,2046
23:04:06,15,998,488,551,1,2038
23:04:07,15,998,492,551,1,2042
23:04:08,15,998,494,551,1,2044
23:04:09,15,998,492,551,1,2042
23:04:10,15,997,488,551,0,2036
23:04:11,15,998,491,551,1,2041
23:04:12,15,998,494,551,1,2044
23:04:13,15,998,502,551,0,2051
23:04:14,15,998,488,551,1,2038
23:04:15,15,998,497,551,1,2047
23:04:16,15,998,491,551,1,2041
23:04:17,15,998,492,551,1,2042
23:04:18,15,998,494,551,1,2044
23:04:19,15,998,497,551,1,2047
23:04:20,15,998,497,551,0,2046
23:04:21,15,998,493,551,1,2043
23:04:22,15,0,0,0,0,0
23:04:23,15,998,491,551,0,2040
23:04:24,15,998,496,551,0,2045
23:04:25,15,998,489,551,0,2038
23:04:26,15,998,492,551,1,2042
23:04:27,15,998,489,551,1,2039
23:04:28,15,0,0,0,0,0
23:04:29,15,998,492,551,1,2042
23:04:30,15,998,490,551,1,2040
23:04:31,15,998,508,551,1,2058
23:04:32,15,998,493,551,1,2043
23:04:33,15,998,494,551,1,2044
23:04:34,15,998,493,551,1,2043
23:04:35,15,998,495,551,1,2045
23:04:36,15,998,496,551,2,2047
23:04:37,15,998,494,551,1,2044
23:04:38,15,998,498,551,0,2047
23:04:39,15,999,494,551,1,2045
23:04:40,15,998,496,551,1,2046
23:04:41,15,998,489,551,1,2039
23:04:42,15,998,496,551,1,2046
23:04:43,15,999,493,551,1,2044
23:04:44,15,999,491,551,1,2042
23:04:45,15,999,498,551,2,2050
23:04:46,15,998,496,551,1,2046
23:04:47,15,0,0,0,0,0
23:04:48,15,999,497,551,0,2047
23:04:49,15,999,491,551,0,2041
23:04:50,15,999,490,551,1,2041
23:04:51,15,999,492,551,1,2043
23:04:52,15,999,490,551,1,2041
23:04:53,15,999,491,551,0,2041
23:04:54,15,0,0,0,0,0
23:04:55,15,999,494,551,1,2045
23:04:56,15,999,492,550,1,2042
23:04:57,15,999,490,551,0,2040
23:04:58,15,999,501,550,2,2052
23:04:59,15,999,492,550,1,2042
23:05:00,15,998,494,550,1,2043
23:05:01,15,998,498,550,1,2047
23:05:02,15,999,486,550,1,2036
23:05:03,15,998,494,550,0,2042
23:05:04,15,999,495,550,0,2044
23:05:05,15,999,495,550,0,2044
23:05:06,15,999,495,549,0,2043
23:05:07,15,999,502,549,1,2051
23:05:08,15,999,496,549,0,2044
23:05:09,15,998,484,549,1,2032
23:05:10,15,999,492,549,2,2042
23:05:11,15,999,491,549,0,2039
23:05:12,15,1000,486,549,0,2035
23:05:13,15,999,498,549,1,2047
23:05:14,15,999,496,549,0,2044
23:05:15,15,999,496,549,1,2045
23:05:16,15,999,489,549,1,2038
23:05:17,15,999,490,549,0,2038
23:05:18,15,999,495,549,1,2044
23:05:19,15,999,491,549,0,2039
23:05:20,15,999,494,549,1,2043
23:05:21,15,999,493,550,1,2043
23:05:22,15,1000,490,550,0,2040
23:05:23,15,999,496,549,1,2045
23:05:24,15,999,487,549,1,2036
23:05:25,15,999,495,550,0,2044
23:05:26,15,999,493,549,1,2042
23:05:27,15,999,494,550,1,2044
23:05:28,15,999,498,549,1,2047
23:05:29,15,999,482,549,1,2031
23:05:30,15,1000,496,549,1,2046
23:05:31,15,999,493,549,1,2042
23:05:32,15,999,493,550,1,2043
23:05:33,15,1000,494,549,0,2043
23:05:34,15,999,494,550,0,2043
23:05:35,15,999,492,550,0,2041
23:05:36,15,998,490,550,0,2038
23:05:37,15,996,486,549,2,2033
23:05:38,15,1000,498,549,0,2047
23:05:39,15,1001,504,550,1,2056
23:05:40,15,1000,491,550,1,2042
23:05:41,15,999,494,550,0,2043
23:05:42,15,1000,482,550,0,2032
23:05:43,15,999,513,550,0,2062
23:05:44,15,1000,500,550,2,2052
23:05:45,15,1000,485,549,1,2035
23:05:46,15,1000,495,549,1,2045
23:05:47,15,1000,491,549,1,2041
23:05:48,15,1000,497,550,1,2048
23:05:49,15,1000,489,550,0,2039
23:05:50,15,1000,495,549,1,2045
23:05:51,15,1000,496,549,1,2046
23:05:52,15,1000,488,549,1,2038
23:05:53,15,1000,493,549,0,2042
23:05:54,15,1001,492,549,1,2043
23:05:55,15,1001,494,549,0,2044
23:05:56,15,1001,501,549,1,2052
23:05:57,15,1001,489,549,2,2041
23:05:58,15,1000,493,549,1,2043
23:05:59,15,1000,494,549,0,2043
23:06:00,15,1000,492,549,1,2042
23:06:01,15,1000,484,549,0,2033
23:06:02,15,1000,482,549,1,2032
23:06:03,15,1000,493,549,1,2043
23:06:04,15,1000,491,549,0,2040
23:06:05,15,1000,494,549,1,2044
23:06:06,15,1000,499,549,0,2048
23:06:07,15,1001,495,549,1,2046
23:06:08,15,1001,495,549,0,2045
23:06:09,15,1000,491,549,1,2041
23:06:10,15,1001,494,549,1,2045
23:06:11,15,1001,490,549,1,2041
23:06:12,15,1000,492,549,2,2043
23:06:13,15,1001,485,549,1,2036
23:06:14,15,1000,488,549,0,2037
23:06:15,15,1000,493,549,1,2043
23:06:16,15,1000,494,548,0,2042
23:06:17,15,1001,503,548,0,2052
23:06:18,15,1000,520,548,1,2069
23:06:19,15,1001,483,548,1,2033
23:06:20,15,1001,490,548,0,2039
23:06:21,15,1001,494,548,1,2044
23:06:22,15,1000,494,548,1,2043
23:06:23,15,1000,489,548,1,2038
23:06:24,15,1000,490,548,1,2039
23:06:25,15,999,493,541,0,2033
,,,,,,
,,,,,,
max,,1015,1006,944,1000,3649